File Name,Number of trades,Number of positive trades,Number of negative trades,Total profit,Total turnover
BANKNIFTY04JAN1825200PE_2018-01-01.csv,7,2,5,-37.5,5329.5
BANKNIFTY04JAN1825300PE_2018-01-01.csv,7,3,4,126.75,11196.75
BANKNIFTY04JAN1825400CE_2018-01-01.csv,2,0,2,-366.75,11285.25
BANKNIFTY04JAN1825400PE_2018-01-01.csv,4,1,3,-102.0,8193.0
BANKNIFTY04JAN1825500CE_2018-01-01.csv,2,0,2,-212.25,7895.25
BANKNIFTY04JAN1825500PE_2018-01-01.csv,4,2,2,166.5,12616.5
BANKNIFTY04JAN1825600CE_2018-01-01.csv,3,0,3,-255.0,6256.5
BANKNIFTY04JAN1825600PE_2018-01-01.csv,4,2,2,293.25,22406.25
BANKNIFTY04JAN1825700CE_2018-01-01.csv,8,1,7,-280.5,12010.5
BANKNIFTY04JAN1825700PE_2018-01-01.csv,4,3,1,1201.5,30069.0
BANKNIFTY04JAN1825800CE_2018-01-01.csv,7,1,6,-93.0,4966.5
BANKNIFTY04JAN1825000PE_2018-01-02.csv,15,6,9,25.5,11832.0
BANKNIFTY04JAN1825100PE_2018-01-02.csv,10,3,7,-185.25,12120.75
BANKNIFTY04JAN1825200CE_2018-01-02.csv,7,0,7,-1441.5,37510.5
BANKNIFTY04JAN1825200PE_2018-01-02.csv,11,5,6,183.0,21954.0
BANKNIFTY04JAN1825300CE_2018-01-02.csv,4,0,4,-616.5,12466.5
BANKNIFTY04JAN1825300PE_2018-01-02.csv,9,4,5,-21.75,28548.75
BANKNIFTY04JAN1825400CE_2018-01-02.csv,5,1,4,-209.25,12020.25
BANKNIFTY04JAN1825400PE_2018-01-02.csv,6,1,5,-609.0,29166.0
BANKNIFTY04JAN1825500CE_2018-01-02.csv,10,1,9,-384.0,11680.5
BANKNIFTY04JAN1825500PE_2018-01-02.csv,8,4,4,460.5,53658.0
BANKNIFTY04JAN1825600CE_2018-01-02.csv,8,3,5,-41.25,4802.25
BANKNIFTY04JAN1825600PE_2018-01-02.csv,10,4,6,523.5,96612.0
BANKNIFTY04JAN1825200CE_2018-01-03.csv,9,2,7,-802.5,53757.0
BANKNIFTY04JAN1825200PE_2018-01-03.csv,4,2,2,30.0,2406.0
BANKNIFTY04JAN1825300CE_2018-01-03.csv,8,2,6,-201.0,27874.5
BANKNIFTY04JAN1825300PE_2018-01-03.csv,5,3,2,200.25,7395.0
BANKNIFTY04JAN1825400CE_2018-01-03.csv,6,2,4,-60.0,11532.0
BANKNIFTY04JAN1825400PE_2018-01-03.csv,5,3,2,300.0,13764.75
BANKNIFTY04JAN1825500CE_2018-01-03.csv,5,1,4,-121.5,4635.0
BANKNIFTY04JAN1825500PE_2018-01-03.csv,5,3,2,375.0,20151.0
BANKNIFTY04JAN1825600PE_2018-01-03.csv,8,5,3,1245.75,55604.25
BANKNIFTY04JAN1825100CE_2018-01-04.csv,8,5,3,1590.0,69493.5
BANKNIFTY04JAN1825200CE_2018-01-04.csv,9,6,3,1738.5,54766.5
BANKNIFTY04JAN1825300CE_2018-01-04.csv,9,5,4,429.75,29264.25
BANKNIFTY04JAN1825300PE_2018-01-04.csv,19,10,9,-90.75,2616.0
BANKNIFTY04JAN1825400CE_2018-01-04.csv,8,3,5,-206.25,8600.25
BANKNIFTY04JAN1825400PE_2018-01-04.csv,7,2,5,45.75,7873.5
BANKNIFTY04JAN1825500PE_2018-01-04.csv,10,2,8,-711.0,27534.0
BANKNIFTY04JAN1825600PE_2018-01-04.csv,8,2,6,-492.75,41705.25
BANKNIFTY11JAN1825200PE_2018-01-05.csv,6,1,5,-51.75,5324.25
BANKNIFTY11JAN1825300CE_2018-01-05.csv,4,2,2,450.0,32332.5
BANKNIFTY11JAN1825300PE_2018-01-05.csv,7,2,5,-15.75,9962.25
BANKNIFTY11JAN1825400CE_2018-01-05.csv,6,3,3,241.5,37180.5
BANKNIFTY11JAN1825400PE_2018-01-05.csv,4,1,3,-132.0,9153.0
BANKNIFTY11JAN1825500CE_2018-01-05.csv,6,3,3,326.25,26561.25
BANKNIFTY11JAN1825500PE_2018-01-05.csv,5,1,4,-105.0,16524.0
BANKNIFTY11JAN1825600CE_2018-01-05.csv,6,2,4,-80.25,17781.75
BANKNIFTY11JAN1825600PE_2018-01-05.csv,5,1,4,-252.0,25155.0
BANKNIFTY11JAN1825700CE_2018-01-05.csv,7,3,4,-41.25,13347.75
BANKNIFTY11JAN1825700PE_2018-01-05.csv,5,1,4,-279.0,32437.5
BANKNIFTY11JAN1825800CE_2018-01-05.csv,7,4,3,114.0,7983.0
BANKNIFTY11JAN1825400PE_2018-01-08.csv,6,3,3,66.75,4718.25
BANKNIFTY11JAN1825500CE_2018-01-08.csv,4,1,3,-399.75,29049.75
BANKNIFTY11JAN1825500PE_2018-01-08.csv,6,1,5,-174.75,7187.25
BANKNIFTY11JAN1825600CE_2018-01-08.csv,5,2,3,191.25,25505.25
BANKNIFTY11JAN1825600PE_2018-01-08.csv,4,2,2,-10.5,9199.5
BANKNIFTY11JAN1825700CE_2018-01-08.csv,6,0,6,-645.0,20529.0
BANKNIFTY11JAN1825700PE_2018-01-08.csv,3,1,2,-95.25,9422.25
BANKNIFTY11JAN1825800CE_2018-01-08.csv,7,1,6,-281.25,14724.75
BANKNIFTY11JAN1825800PE_2018-01-08.csv,5,2,3,-62.25,25965.0
BANKNIFTY11JAN1825900CE_2018-01-08.csv,8,1,7,-186.0,10263.0
BANKNIFTY11JAN1825900PE_2018-01-08.csv,5,3,2,518.25,37101.75
BANKNIFTY11JAN1826000CE_2018-01-08.csv,11,1,10,-210.75,7479.75
BANKNIFTY11JAN1825400CE_2018-01-09.csv,5,2,3,208.5,44650.5
BANKNIFTY11JAN1825400PE_2018-01-09.csv,11,5,6,45.0,6889.5
BANKNIFTY11JAN1825500CE_2018-01-09.csv,6,2,4,-24.0,34099.5
BANKNIFTY11JAN1825500PE_2018-01-09.csv,7,3,4,73.5,7195.5
BANKNIFTY11JAN1825600CE_2018-01-09.csv,4,1,3,-183.0,14466.0
BANKNIFTY11JAN1825600PE_2018-01-09.csv,7,2,5,-47.25,13332.75
BANKNIFTY11JAN1825700CE_2018-01-09.csv,6,3,3,154.5,14022.0
BANKNIFTY11JAN1825700PE_2018-01-09.csv,6,2,4,10.5,19386.0
BANKNIFTY11JAN1825800CE_2018-01-09.csv,9,4,5,145.5,9795.0
BANKNIFTY11JAN1825800PE_2018-01-09.csv,5,3,2,421.5,28298.25
BANKNIFTY11JAN1825900CE_2018-01-09.csv,14,4,10,-27.0,6849.0
BANKNIFTY11JAN1825900PE_2018-01-09.csv,8,2,6,-775.5,60669.0
BANKNIFTY11JAN1825400CE_2018-01-10.csv,8,3,5,-135.0,51150.0
BANKNIFTY11JAN1825500CE_2018-01-10.csv,9,4,5,42.75,34354.5
BANKNIFTY11JAN1825500PE_2018-01-10.csv,12,7,5,311.25,11319.75
BANKNIFTY11JAN1825600CE_2018-01-10.csv,9,3,6,-183.75,17828.25
BANKNIFTY11JAN1825600PE_2018-01-10.csv,9,2,7,-192.75,18464.25
BANKNIFTY11JAN1825700CE_2018-01-10.csv,8,2,6,-179.25,7169.25
BANKNIFTY11JAN1825700PE_2018-01-10.csv,11,7,4,871.5,41190.0
BANKNIFTY11JAN1825800CE_2018-01-10.csv,14,5,9,-72.75,5288.25
BANKNIFTY11JAN1825800PE_2018-01-10.csv,6,4,2,881.25,39478.5
BANKNIFTY11JAN1825400CE_2018-01-11.csv,6,4,2,1040.25,41639.25
BANKNIFTY11JAN1825500CE_2018-01-11.csv,10,7,3,1347.75,38984.25
BANKNIFTY11JAN1825600CE_2018-01-11.csv,12,9,3,806.25,15600.75
BANKNIFTY11JAN1825600PE_2018-01-11.csv,8,2,6,-185.25,4671.0
BANKNIFTY11JAN1825700PE_2018-01-11.csv,5,0,5,-413.25,11447.25
BANKNIFTY11JAN1825800PE_2018-01-11.csv,6,2,4,-364.5,29121.0
BANKNIFTY18JAN1824900PE_2018-01-12.csv,14,4,10,-15.0,4168.5
BANKNIFTY18JAN1825300PE_2018-01-12.csv,7,2,5,-51.75,5757.75
BANKNIFTY18JAN1825400PE_2018-01-12.csv,8,2,6,-207.0,9211.5
BANKNIFTY18JAN1825500CE_2018-01-12.csv,5,2,3,80.25,38859.0
BANKNIFTY18JAN1825500PE_2018-01-12.csv,10,3,7,-256.5,17058.0
BANKNIFTY18JAN1825600CE_2018-01-12.csv,7,3,4,219.75,37600.5
BANKNIFTY18JAN1825600PE_2018-01-12.csv,3,1,2,-57.0,8106.0
BANKNIFTY18JAN1825700CE_2018-01-12.csv,5,2,3,120.75,17486.25
BANKNIFTY18JAN1825700PE_2018-01-12.csv,6,2,4,-306.75,22231.5
BANKNIFTY18JAN1825800CE_2018-01-12.csv,7,3,4,111.0,15886.5
BANKNIFTY18JAN1825800PE_2018-01-12.csv,9,3,6,-259.5,49585.5
BANKNIFTY18JAN1825900CE_2018-01-12.csv,5,0,5,-180.0,6108.0
BANKNIFTY18JAN1825900PE_2018-01-12.csv,6,1,5,-811.5,49441.5
BANKNIFTY18JAN1825500PE_2018-01-15.csv,9,2,7,-83.25,5049.75
BANKNIFTY18JAN1825600PE_2018-01-15.csv,8,0,8,-216.0,6980.25
BANKNIFTY18JAN1825700CE_2018-01-15.csv,9,6,3,1802.25,80862.0
BANKNIFTY18JAN1825700PE_2018-01-15.csv,6,0,6,-267.0,7398.0
BANKNIFTY18JAN1825800CE_2018-01-15.csv,9,7,2,1719.75,57942.75
BANKNIFTY18JAN1825800PE_2018-01-15.csv,8,1,7,-345.0,15508.5
BANKNIFTY18JAN1825900CE_2018-01-15.csv,9,6,3,859.5,39621.0
BANKNIFTY18JAN1825900PE_2018-01-15.csv,6,1,5,-406.5,16867.5
BANKNIFTY18JAN1826000CE_2018-01-15.csv,8,6,2,576.75,23235.75
BANKNIFTY18JAN1826000PE_2018-01-15.csv,8,1,7,-731.25,33805.5
BANKNIFTY18JAN1826100CE_2018-01-15.csv,9,7,2,504.0,15583.5
BANKNIFTY18JAN1826100PE_2018-01-15.csv,9,2,7,-840.75,58107.0
BANKNIFTY18JAN1826200CE_2018-01-15.csv,11,7,4,150.0,10023.0
BANKNIFTY18JAN1825700CE_2018-01-16.csv,6,1,5,-1163.25,57024.0
BANKNIFTY18JAN1825700PE_2018-01-16.csv,9,4,5,66.75,7067.25
BANKNIFTY18JAN1825800CE_2018-01-16.csv,10,3,7,-538.5,61984.5
BANKNIFTY18JAN1825800PE_2018-01-16.csv,9,2,7,-131.25,10514.25
BANKNIFTY18JAN1825900CE_2018-01-16.csv,7,3,4,138.75,31529.25
BANKNIFTY18JAN1825900PE_2018-01-16.csv,6,2,4,-49.5,11292.0
BANKNIFTY18JAN1826000CE_2018-01-16.csv,10,4,6,-12.75,25796.25
BANKNIFTY18JAN1826000PE_2018-01-16.csv,9,2,7,-368.25,27500.25
BANKNIFTY18JAN1826100CE_2018-01-16.csv,9,2,7,-215.25,12692.25
BANKNIFTY18JAN1826100PE_2018-01-16.csv,8,2,6,-378.0,37347.0
BANKNIFTY18JAN1826200CE_2018-01-16.csv,11,3,8,-105.75,8058.75
BANKNIFTY18JAN1826200PE_2018-01-16.csv,11,5,6,601.5,80216.25
BANKNIFTY18JAN1825700CE_2018-01-17.csv,8,6,2,2950.5,87489.0
BANKNIFTY18JAN1825800CE_2018-01-17.csv,8,6,2,1928.25,63998.25
BANKNIFTY18JAN1825800PE_2018-01-17.csv,11,2,9,-150.75,4985.25
BANKNIFTY18JAN1825900CE_2018-01-17.csv,8,5,3,708.0,43014.0
BANKNIFTY18JAN1825900PE_2018-01-17.csv,7,1,6,-138.75,4028.25
BANKNIFTY18JAN1826000CE_2018-01-17.csv,5,4,1,351.0,19005.0
BANKNIFTY18JAN1826000PE_2018-01-17.csv,6,1,5,-178.5,7983.0
BANKNIFTY18JAN1826100CE_2018-01-17.csv,8,3,5,-91.5,15556.5
BANKNIFTY18JAN1826100PE_2018-01-17.csv,10,2,8,-652.5,21867.0
BANKNIFTY18JAN1826200PE_2018-01-17.csv,11,1,10,-1526.25,48452.25
BANKNIFTY18JAN1826200CE_2018-01-18.csv,8,2,6,-879.0,114382.5
BANKNIFTY18JAN1826300CE_2018-01-18.csv,12,2,10,-2642.25,130323.75
BANKNIFTY18JAN1826400CE_2018-01-18.csv,8,3,5,38.25,78975.0
BANKNIFTY18JAN1826400PE_2018-01-18.csv,37,20,17,336.75,1426.5
BANKNIFTY18JAN1826500CE_2018-01-18.csv,8,2,6,-436.5,51894.0
BANKNIFTY18JAN1826500PE_2018-01-18.csv,18,2,16,-326.25,2635.5
BANKNIFTY18JAN1826600CE_2018-01-18.csv,13,6,7,-383.25,36606.0
BANKNIFTY18JAN1826600PE_2018-01-18.csv,13,8,5,21.75,8043.75
BANKNIFTY18JAN1826700CE_2018-01-18.csv,15,5,10,-249.75,17625.0
BANKNIFTY18JAN1826700PE_2018-01-18.csv,14,6,8,-251.25,29357.25
BANKNIFTY18JAN1826800CE_2018-01-18.csv,14,9,5,33.0,3000.75
BANKNIFTY18JAN1826800PE_2018-01-18.csv,13,6,7,-41.25,47875.5
BANKNIFTY18JAN1826900CE_2018-01-18.csv,19,7,12,-86.25,2223.0
BANKNIFTY18JAN1826900PE_2018-01-18.csv,14,5,9,1951.5,76806.0
BANKNIFTY18JAN1827000PE_2018-01-18.csv,12,3,9,-2227.5,110328.0
BANKNIFTY25JAN1825800PE_2018-01-19.csv,10,4,6,4.5,5242.5
BANKNIFTY25JAN1825900PE_2018-01-19.csv,12,3,9,-131.25,7733.25
BANKNIFTY25JAN1826000PE_2018-01-19.csv,7,1,6,-153.0,5676.0
BANKNIFTY25JAN1826100PE_2018-01-19.csv,9,4,5,81.75,9128.25
BANKNIFTY25JAN1826200PE_2018-01-19.csv,15,7,8,186.75,20670.75
BANKNIFTY25JAN1826300CE_2018-01-19.csv,9,5,4,1533.0,117762.0
BANKNIFTY25JAN1826300PE_2018-01-19.csv,8,2,6,-167.25,14810.25
BANKNIFTY25JAN1826400CE_2018-01-19.csv,10,7,3,3317.25,108805.5
BANKNIFTY25JAN1826400PE_2018-01-19.csv,11,3,8,-345.0,28104.0
BANKNIFTY25JAN1826500CE_2018-01-19.csv,7,1,6,-630.75,57662.25
BANKNIFTY25JAN1826500PE_2018-01-19.csv,7,1,6,-560.25,23489.25
BANKNIFTY25JAN1826600CE_2018-01-19.csv,11,5,6,474.0,73296.0
BANKNIFTY25JAN1826600PE_2018-01-19.csv,7,3,4,223.5,30754.5
BANKNIFTY25JAN1826700CE_2018-01-19.csv,10,2,8,-795.0,43351.5
BANKNIFTY25JAN1826700PE_2018-01-19.csv,10,2,8,-778.5,64156.5
BANKNIFTY25JAN1826800CE_2018-01-19.csv,10,4,6,134.25,36810.0
BANKNIFTY25JAN1826800PE_2018-01-19.csv,10,2,8,-755.25,82065.75
BANKNIFTY25JAN1826900CE_2018-01-19.csv,10,2,8,-412.5,22495.5
BANKNIFTY25JAN1826900PE_2018-01-19.csv,12,3,9,-1266.75,116142.75
BANKNIFTY25JAN1827000CE_2018-01-19.csv,11,2,9,-325.5,19857.0
BANKNIFTY25JAN1827100CE_2018-01-19.csv,11,4,7,33.0,12546.0
BANKNIFTY25JAN1827200CE_2018-01-19.csv,13,5,8,-8.25,11381.25
BANKNIFTY25JAN1826200PE_2018-01-22.csv,11,4,7,37.5,7462.5
BANKNIFTY25JAN1826300PE_2018-01-22.csv,8,4,4,68.25,7032.75
BANKNIFTY25JAN1826400PE_2018-01-22.csv,9,4,5,77.25,11472.75
BANKNIFTY25JAN1826500PE_2018-01-22.csv,9,4,5,98.25,15455.25
BANKNIFTY25JAN1826600PE_2018-01-22.csv,5,3,2,172.5,12424.5
BANKNIFTY25JAN1826700CE_2018-01-22.csv,11,4,7,-129.0,108322.5
BANKNIFTY25JAN1826700PE_2018-01-22.csv,8,5,3,546.0,24184.5
BANKNIFTY25JAN1826800CE_2018-01-22.csv,12,4,8,-345.0,91657.5
BANKNIFTY25JAN1826800PE_2018-01-22.csv,7,2,5,-550.5,27096.0
BANKNIFTY25JAN1826900CE_2018-01-22.csv,8,4,4,253.5,46791.0
BANKNIFTY25JAN1826900PE_2018-01-22.csv,6,2,4,-412.5,32412.0
BANKNIFTY25JAN1827000CE_2018-01-22.csv,6,2,4,-510.75,25238.25
BANKNIFTY25JAN1827000PE_2018-01-22.csv,8,3,5,-338.25,53829.75
BANKNIFTY25JAN1827100CE_2018-01-22.csv,6,1,5,-611.25,22123.5
BANKNIFTY25JAN1827200CE_2018-01-22.csv,7,2,5,-450.75,17831.25
BANKNIFTY25JAN1827300CE_2018-01-22.csv,8,1,7,-403.5,15273.0
BANKNIFTY25JAN1827400CE_2018-01-22.csv,10,1,9,-624.0,15201.75
BANKNIFTY25JAN1827500CE_2018-01-22.csv,11,3,8,-302.25,11715.75
BANKNIFTY25JAN1827600CE_2018-01-22.csv,20,8,12,-69.75,17529.0
BANKNIFTY25JAN1827700CE_2018-01-22.csv,22,9,13,-12.75,12687.75
BANKNIFTY25JAN1827800CE_2018-01-22.csv,20,6,14,-168.0,9241.5
BANKNIFTY25JAN1826500PE_2018-01-23.csv,11,3,8,-73.5,6813.0
BANKNIFTY25JAN1826600PE_2018-01-23.csv,11,2,9,-153.75,9062.25
BANKNIFTY25JAN1826700PE_2018-01-23.csv,9,2,7,-132.0,9268.5
BANKNIFTY25JAN1826800PE_2018-01-23.csv,10,1,9,-445.5,15219.75
BANKNIFTY25JAN1826900CE_2018-01-23.csv,9,6,3,3162.75,104661.75
BANKNIFTY25JAN1826900PE_2018-01-23.csv,11,2,9,-487.5,22515.75
BANKNIFTY25JAN1827000CE_2018-01-23.csv,7,5,2,1739.25,63625.5
BANKNIFTY25JAN1827000PE_2018-01-23.csv,6,0,6,-639.75,15744.0
BANKNIFTY25JAN1827100CE_2018-01-23.csv,8,6,2,2091.75,59220.0
BANKNIFTY25JAN1827100PE_2018-01-23.csv,10,0,10,-1387.5,34693.5
BANKNIFTY25JAN1827200CE_2018-01-23.csv,6,6,0,2058.75,36557.25
BANKNIFTY25JAN1827200PE_2018-01-23.csv,9,2,7,-606.75,43133.25
BANKNIFTY25JAN1827300CE_2018-01-23.csv,9,7,2,1458.0,32400.0
BANKNIFTY25JAN1827300PE_2018-01-23.csv,16,3,13,-2193.0,100677.75
BANKNIFTY25JAN1827400CE_2018-01-23.csv,6,5,1,764.25,17730.0
BANKNIFTY25JAN1827500CE_2018-01-23.csv,10,6,4,388.5,16999.5
BANKNIFTY25JAN1827600CE_2018-01-23.csv,11,6,5,275.25,12477.75
BANKNIFTY25JAN1826600PE_2018-01-24.csv,23,7,16,-98.25,10247.25
BANKNIFTY25JAN1826700PE_2018-01-24.csv,11,4,7,-37.5,6148.5
BANKNIFTY25JAN1826800PE_2018-01-24.csv,13,3,10,-166.5,8638.5
BANKNIFTY25JAN1826900PE_2018-01-24.csv,13,4,9,-148.5,13135.5
BANKNIFTY25JAN1827000PE_2018-01-24.csv,10,3,7,-119.25,13109.25
BANKNIFTY25JAN1827100CE_2018-01-24.csv,12,4,8,-465.75,117165.75
BANKNIFTY25JAN1827100PE_2018-01-24.csv,15,3,12,-330.0,27928.5
BANKNIFTY25JAN1827200CE_2018-01-24.csv,11,3,8,-888.0,81216.0
BANKNIFTY25JAN1827200PE_2018-01-24.csv,12,5,7,-7.5,32011.5
BANKNIFTY25JAN1827300CE_2018-01-24.csv,11,5,6,455.25,60966.75
BANKNIFTY25JAN1827300PE_2018-01-24.csv,9,5,4,388.5,30630.0
BANKNIFTY25JAN1827400CE_2018-01-24.csv,9,2,7,-593.25,36752.25
BANKNIFTY25JAN1827400PE_2018-01-24.csv,11,4,7,-228.0,54709.5
BANKNIFTY25JAN1827500CE_2018-01-24.csv,10,3,7,-305.25,28470.75
BANKNIFTY25JAN1827500PE_2018-01-24.csv,12,5,7,219.0,77826.0
BANKNIFTY25JAN1827600CE_2018-01-24.csv,13,5,8,-300.0,26224.5
BANKNIFTY25JAN1827700CE_2018-01-24.csv,14,7,7,93.75,21128.25
BANKNIFTY25JAN1827800CE_2018-01-24.csv,15,6,9,36.75,15672.75
BANKNIFTY25JAN1827900CE_2018-01-24.csv,15,7,8,-1.5,10966.5
BANKNIFTY25JAN1827000CE_2018-01-25.csv,12,4,8,-448.5,122931.0
BANKNIFTY25JAN1827100CE_2018-01-25.csv,13,1,12,-3524.25,88214.25
BANKNIFTY25JAN1827100PE_2018-01-25.csv,15,8,7,16.5,4209.75
BANKNIFTY25JAN1827200CE_2018-01-25.csv,13,3,10,-1642.5,62734.5
BANKNIFTY25JAN1827200PE_2018-01-25.csv,13,10,3,513.75,9519.0
BANKNIFTY25JAN1827300CE_2018-01-25.csv,11,3,8,-1183.5,27084.0
BANKNIFTY25JAN1827300PE_2018-01-25.csv,14,8,6,629.25,22420.5
BANKNIFTY25JAN1827400CE_2018-01-25.csv,13,4,9,-325.5,16444.5
BANKNIFTY25JAN1827400PE_2018-01-25.csv,13,7,6,333.0,35087.25
BANKNIFTY25JAN1827500CE_2018-01-25.csv,12,1,11,-303.75,4500.0
BANKNIFTY25JAN1827500PE_2018-01-25.csv,11,7,4,1107.0,60685.5
BANKNIFTY25JAN1827600CE_2018-01-25.csv,16,2,14,-139.5,2697.75
BANKNIFTY25JAN1827600PE_2018-01-25.csv,15,8,7,1996.5,119562.0
BANKNIFTY01FEB1826400PE_2018-01-29.csv,10,4,6,45.75,10834.5
BANKNIFTY01FEB1826500PE_2018-01-29.csv,5,2,3,40.5,7086.0
BANKNIFTY01FEB1826600PE_2018-01-29.csv,7,2,5,-40.5,11973.0
BANKNIFTY01FEB1826700PE_2018-01-29.csv,7,3,4,158.25,14276.25
BANKNIFTY01FEB1826800PE_2018-01-29.csv,8,1,7,-471.75,21130.5
BANKNIFTY01FEB1826900PE_2018-01-29.csv,8,2,6,-231.75,26172.0
BANKNIFTY01FEB1827000PE_2018-01-29.csv,7,1,6,-662.25,28949.25
BANKNIFTY01FEB1827100PE_2018-01-29.csv,8,2,6,-460.5,40702.5
BANKNIFTY01FEB1827200PE_2018-01-29.csv,8,2,6,-461.25,49602.75
BANKNIFTY01FEB1827300PE_2018-01-29.csv,5,1,4,-498.75,37490.25
BANKNIFTY01FEB1827400CE_2018-01-29.csv,5,0,5,-2019.75,63737.25
BANKNIFTY01FEB1827400PE_2018-01-29.csv,6,1,5,-795.0,52100.25
BANKNIFTY01FEB1827500CE_2018-01-29.csv,4,1,3,-395.25,44726.25
BANKNIFTY01FEB1827500PE_2018-01-29.csv,6,1,5,-1126.5,61941.0
BANKNIFTY01FEB1827600CE_2018-01-29.csv,5,0,5,-1367.25,44016.75
BANKNIFTY01FEB1827700CE_2018-01-29.csv,4,0,4,-852.0,31163.25
BANKNIFTY01FEB1827800CE_2018-01-29.csv,6,0,6,-1266.0,38197.5
BANKNIFTY01FEB1827900CE_2018-01-29.csv,7,0,7,-1268.25,40146.75
BANKNIFTY01FEB1828000CE_2018-01-29.csv,5,0,5,-764.25,24440.25
BANKNIFTY01FEB1828100CE_2018-01-29.csv,5,0,5,-654.75,19527.0
BANKNIFTY01FEB1828200CE_2018-01-29.csv,5,0,5,-523.5,15279.0
BANKNIFTY01FEB1828300CE_2018-01-29.csv,6,0,6,-547.5,14694.0
BANKNIFTY01FEB1828400CE_2018-01-29.csv,6,1,5,-238.5,12814.5
BANKNIFTY01FEB1828500CE_2018-01-29.csv,7,1,6,-229.5,11614.5
BANKNIFTY01FEB1828600CE_2018-01-29.csv,11,5,6,80.25,13182.75
BANKNIFTY01FEB1826200PE_2018-01-30.csv,24,6,18,-213.75,12495.75
BANKNIFTY01FEB1826300PE_2018-01-30.csv,23,7,16,-91.5,16204.5
BANKNIFTY01FEB1826400PE_2018-01-30.csv,18,7,11,-93.0,16656.0
BANKNIFTY01FEB1826500PE_2018-01-30.csv,15,6,9,-31.5,18981.0
BANKNIFTY01FEB1826600PE_2018-01-30.csv,16,6,10,-222.75,25083.75
BANKNIFTY01FEB1826700PE_2018-01-30.csv,11,2,9,-499.5,24147.0
BANKNIFTY01FEB1826800PE_2018-01-30.csv,9,2,7,-416.25,22638.75
BANKNIFTY01FEB1826900PE_2018-01-30.csv,10,2,8,-515.25,32177.25
BANKNIFTY01FEB1827000PE_2018-01-30.csv,9,2,7,-462.0,38083.5
BANKNIFTY01FEB1827100PE_2018-01-30.csv,6,2,4,-187.5,32571.75
BANKNIFTY01FEB1827200PE_2018-01-30.csv,8,2,6,-743.25,49971.75
BANKNIFTY01FEB1827300CE_2018-01-30.csv,5,0,5,-1378.5,48582.75
BANKNIFTY01FEB1827300PE_2018-01-30.csv,6,3,3,295.5,47514.75
BANKNIFTY01FEB1827400CE_2018-01-30.csv,5,0,5,-1313.25,34817.25
BANKNIFTY01FEB1827400PE_2018-01-30.csv,6,1,5,-1032.0,58671.0
BANKNIFTY01FEB1827500CE_2018-01-30.csv,6,0,6,-1115.25,35117.25
BANKNIFTY01FEB1827600CE_2018-01-30.csv,5,0,5,-852.75,25844.25
BANKNIFTY01FEB1827700CE_2018-01-30.csv,5,0,5,-649.5,20013.0
BANKNIFTY01FEB1827800CE_2018-01-30.csv,6,0,6,-692.25,19067.25
BANKNIFTY01FEB1827900CE_2018-01-30.csv,6,0,6,-620.25,16181.25
BANKNIFTY01FEB1828000CE_2018-01-30.csv,8,1,7,-383.25,16647.0
BANKNIFTY01FEB1828100CE_2018-01-30.csv,8,0,8,-437.25,12531.75
BANKNIFTY01FEB1828200CE_2018-01-30.csv,12,2,10,-321.75,13485.75
BANKNIFTY01FEB1828300CE_2018-01-30.csv,13,0,13,-393.0,11199.0
BANKNIFTY01FEB1828400CE_2018-01-30.csv,15,2,13,-343.5,9997.5
BANKNIFTY01FEB1828500CE_2018-01-30.csv,16,0,16,-354.75,8444.25
BANKNIFTY01FEB1828600CE_2018-01-30.csv,16,3,13,-185.25,6212.25
BANKNIFTY01FEB1826400PE_2018-01-31.csv,16,7,9,119.25,10738.5
BANKNIFTY01FEB1826500PE_2018-01-31.csv,16,6,10,54.0,13089.0
BANKNIFTY01FEB1826600PE_2018-01-31.csv,13,4,9,-101.25,14791.5
BANKNIFTY01FEB1826700PE_2018-01-31.csv,10,5,5,200.25,15115.5
BANKNIFTY01FEB1826800PE_2018-01-31.csv,12,6,6,261.0,22673.25
BANKNIFTY01FEB1826900PE_2018-01-31.csv,8,4,4,285.0,20073.0
BANKNIFTY01FEB1827000PE_2018-01-31.csv,8,2,6,-243.0,26578.5
BANKNIFTY01FEB1827100CE_2018-01-31.csv,9,4,5,1046.25,100602.75
BANKNIFTY01FEB1827100PE_2018-01-31.csv,8,2,6,-520.5,33912.75
BANKNIFTY01FEB1827200CE_2018-01-31.csv,5,1,4,-798.75,46740.0
BANKNIFTY01FEB1827200PE_2018-01-31.csv,7,2,5,-465.75,38814.75
BANKNIFTY01FEB1827300CE_2018-01-31.csv,8,3,5,563.25,58942.5
BANKNIFTY01FEB1827300PE_2018-01-31.csv,5,1,4,-512.25,36262.5
BANKNIFTY01FEB1827400CE_2018-01-31.csv,7,2,5,-460.5,37375.5
BANKNIFTY01FEB1827400PE_2018-01-31.csv,8,3,5,-487.5,60202.5
BANKNIFTY01FEB1827500CE_2018-01-31.csv,5,0,5,-648.0,18921.0
BANKNIFTY01FEB1827500PE_2018-01-31.csv,5,2,3,-88.5,50533.5
BANKNIFTY01FEB1827600CE_2018-01-31.csv,10,4,6,-155.25,29396.25
BANKNIFTY01FEB1827700CE_2018-01-31.csv,7,2,5,-206.25,15167.25
BANKNIFTY01FEB1827800CE_2018-01-31.csv,9,2,7,-243.0,14103.0
BANKNIFTY01FEB1827900CE_2018-01-31.csv,16,6,10,105.75,20003.25
BANKNIFTY01FEB1828000CE_2018-01-31.csv,9,3,6,-25.5,7789.5
BANKNIFTY01FEB1826700PE_2018-02-01.csv,31,18,13,-49.5,6519.75
BANKNIFTY01FEB1826800PE_2018-02-01.csv,29,14,15,-190.5,9729.75
BANKNIFTY01FEB1826900PE_2018-02-01.csv,23,12,11,-116.25,11905.5
BANKNIFTY01FEB1827000CE_2018-02-01.csv,13,2,11,-4284.0,179202.0
BANKNIFTY01FEB1827000PE_2018-02-01.csv,19,8,11,-87.75,13827.0
BANKNIFTY01FEB1827100PE_2018-02-01.csv,15,5,10,-426.75,18016.5
BANKNIFTY01FEB1827200CE_2018-02-01.csv,11,7,4,1693.5,96939.0
BANKNIFTY01FEB1827200PE_2018-02-01.csv,16,6,10,-330.0,24327.0
BANKNIFTY01FEB1827300CE_2018-02-01.csv,16,7,9,-1058.25,90241.5
BANKNIFTY01FEB1827300PE_2018-02-01.csv,14,9,5,303.0,31513.5
BANKNIFTY01FEB1827400CE_2018-02-01.csv,13,2,11,-1323.0,59363.25
BANKNIFTY01FEB1827400PE_2018-02-01.csv,12,7,5,1050.75,50178.0
BANKNIFTY01FEB1827500CE_2018-02-01.csv,13,6,7,-223.5,27713.25
BANKNIFTY01FEB1827500PE_2018-02-01.csv,12,7,5,1738.5,61087.5
BANKNIFTY01FEB1827600CE_2018-02-01.csv,15,8,7,3.75,22165.5
BANKNIFTY01FEB1827600PE_2018-02-01.csv,10,3,7,-859.5,76735.5
BANKNIFTY01FEB1827700CE_2018-02-01.csv,14,9,5,32.25,8563.5
BANKNIFTY01FEB1827700PE_2018-02-01.csv,19,8,11,479.25,184956.75
BANKNIFTY01FEB1827800CE_2018-02-01.csv,16,8,8,-57.75,12985.5
BANKNIFTY01FEB1827900CE_2018-02-01.csv,22,12,10,60.0,8585.25
BANKNIFTY01FEB1828000CE_2018-02-01.csv,23,13,10,-183.75,7236.0
BANKNIFTY01FEB1828100CE_2018-02-01.csv,24,14,10,-215.25,4102.5
BANKNIFTY01FEB1828200CE_2018-02-01.csv,27,15,12,-63.0,3588.75
BANKNIFTY08FEB1825500PE_2018-02-02.csv,19,11,8,270.0,14041.5
BANKNIFTY08FEB1825800PE_2018-02-02.csv,19,11,8,407.25,26330.25
BANKNIFTY08FEB1826000PE_2018-02-02.csv,13,8,5,682.5,26793.0
BANKNIFTY08FEB1826100PE_2018-02-02.csv,11,5,6,377.25,30065.25
BANKNIFTY08FEB1826200PE_2018-02-02.csv,11,7,4,900.0,33213.0
BANKNIFTY08FEB1826300PE_2018-02-02.csv,12,7,5,853.5,44043.0
BANKNIFTY08FEB1826400PE_2018-02-02.csv,13,8,5,1155.0,55053.0
BANKNIFTY08FEB1826500PE_2018-02-02.csv,10,6,4,991.5,50064.0
BANKNIFTY08FEB1826600CE_2018-02-02.csv,15,3,12,-2317.5,146665.5
BANKNIFTY08FEB1826600PE_2018-02-02.csv,10,6,4,1560.0,59584.5
BANKNIFTY08FEB1826700CE_2018-02-02.csv,10,2,8,-1285.5,78251.25
BANKNIFTY08FEB1826700PE_2018-02-02.csv,8,6,2,2022.75,58854.75
BANKNIFTY08FEB1826800CE_2018-02-02.csv,12,1,11,-2229.0,72906.0
BANKNIFTY08FEB1826800PE_2018-02-02.csv,11,5,6,1163.25,93705.75
BANKNIFTY08FEB1826900CE_2018-02-02.csv,12,2,10,-1360.5,55404.0
BANKNIFTY08FEB1826900PE_2018-02-02.csv,15,10,5,4152.75,155274.75
BANKNIFTY08FEB1827000CE_2018-02-02.csv,7,0,7,-981.75,24479.25
BANKNIFTY08FEB1827000PE_2018-02-02.csv,12,7,5,2452.5,149350.5
BANKNIFTY08FEB1827100CE_2018-02-02.csv,10,1,9,-794.25,25461.75
BANKNIFTY08FEB1827100PE_2018-02-02.csv,11,6,5,2956.5,153612.0
BANKNIFTY08FEB1827200CE_2018-02-02.csv,8,3,5,-1.5,15487.5
BANKNIFTY08FEB1827300CE_2018-02-02.csv,8,1,7,-290.25,9881.25
BANKNIFTY08FEB1827400CE_2018-02-02.csv,10,3,7,-42.75,9870.0
BANKNIFTY08FEB1827500CE_2018-02-02.csv,15,4,11,-121.5,10323.75
BANKNIFTY08FEB1827600CE_2018-02-02.csv,15,4,11,-72.75,6573.0
BANKNIFTY08FEB1827700CE_2018-02-02.csv,18,5,13,-78.0,5283.0
BANKNIFTY08FEB1825000PE_2018-02-05.csv,17,7,10,-8.25,14251.5
BANKNIFTY08FEB1825200PE_2018-02-05.csv,22,8,14,-75.0,25269.0
BANKNIFTY08FEB1825300PE_2018-02-05.csv,24,8,16,-117.75,33758.25
BANKNIFTY08FEB1825400PE_2018-02-05.csv,20,7,13,-195.75,34955.25
BANKNIFTY08FEB1825500PE_2018-02-05.csv,17,5,12,-618.75,38145.75
BANKNIFTY08FEB1825600PE_2018-02-05.csv,17,5,12,-164.25,47512.5
BANKNIFTY08FEB1825700PE_2018-02-05.csv,16,4,12,-987.75,52160.25
BANKNIFTY08FEB1825800PE_2018-02-05.csv,13,1,12,-1786.5,49824.0
BANKNIFTY08FEB1825900PE_2018-02-05.csv,13,5,8,-41.25,61599.75
BANKNIFTY08FEB1826000CE_2018-02-05.csv,7,3,4,348.75,67673.25
BANKNIFTY08FEB1826000PE_2018-02-05.csv,9,1,8,-1695.75,52154.25
BANKNIFTY08FEB1826100CE_2018-02-05.csv,9,4,5,628.5,72138.0
BANKNIFTY08FEB1826100PE_2018-02-05.csv,9,1,8,-2043.75,63502.5
BANKNIFTY08FEB1826200CE_2018-02-05.csv,10,5,5,854.25,66188.25
BANKNIFTY08FEB1826200PE_2018-02-05.csv,12,2,10,-2763.75,98395.5
BANKNIFTY08FEB1826300CE_2018-02-05.csv,10,5,5,691.5,50188.5
BANKNIFTY08FEB1826300PE_2018-02-05.csv,14,3,11,-2487.75,135333.75
BANKNIFTY08FEB1826400CE_2018-02-05.csv,6,3,3,379.5,23637.0
BANKNIFTY08FEB1826400PE_2018-02-05.csv,20,8,12,60.0,223828.5
BANKNIFTY08FEB1826500CE_2018-02-05.csv,8,6,2,727.5,20953.5
BANKNIFTY08FEB1826600CE_2018-02-05.csv,9,4,5,236.25,18035.25
BANKNIFTY08FEB1826700CE_2018-02-05.csv,10,4,6,18.75,13476.75
BANKNIFTY08FEB1826800CE_2018-02-05.csv,11,4,7,-13.5,9073.5
BANKNIFTY08FEB1826900CE_2018-02-05.csv,10,4,6,23.25,6791.25
BANKNIFTY08FEB1823400PE_2018-02-06.csv,36,14,22,114.0,18607.5
BANKNIFTY08FEB1823500PE_2018-02-06.csv,22,8,14,-75.0,13984.5
BANKNIFTY08FEB1824000PE_2018-02-06.csv,16,4,12,-153.75,18717.75
BANKNIFTY08FEB1824500PE_2018-02-06.csv,20,11,9,372.75,44385.75
BANKNIFTY08FEB1824600PE_2018-02-06.csv,21,5,16,-873.75,60972.75
BANKNIFTY08FEB1824700PE_2018-02-06.csv,19,5,14,-1368.0,54999.0
BANKNIFTY08FEB1824800PE_2018-02-06.csv,14,3,11,-1732.5,58932.0
BANKNIFTY08FEB1824900PE_2018-02-06.csv,12,2,10,-1580.25,50586.75
BANKNIFTY08FEB1825000CE_2018-02-06.csv,14,8,6,4139.25,275993.25
BANKNIFTY08FEB1825000PE_2018-02-06.csv,10,2,8,-1072.5,55260.0
BANKNIFTY08FEB1825100PE_2018-02-06.csv,17,3,14,-3207.0,98601.0
BANKNIFTY08FEB1825200CE_2018-02-06.csv,10,5,5,177.75,159277.5
BANKNIFTY08FEB1825200PE_2018-02-06.csv,17,4,13,-1590.0,113913.0
BANKNIFTY08FEB1825300CE_2018-02-06.csv,12,7,5,2145.0,171951.0
BANKNIFTY08FEB1825300PE_2018-02-06.csv,17,5,12,-1314.75,126692.25
BANKNIFTY08FEB1825400CE_2018-02-06.csv,10,5,5,1887.75,107003.25
BANKNIFTY08FEB1825400PE_2018-02-06.csv,17,4,13,-3291.0,157281.0
BANKNIFTY08FEB1825500CE_2018-02-06.csv,9,4,5,-192.0,91128.75
BANKNIFTY08FEB1825500PE_2018-02-06.csv,17,3,14,-4410.75,167447.25
BANKNIFTY08FEB1825600CE_2018-02-06.csv,13,6,7,651.75,94054.5
BANKNIFTY08FEB1825600PE_2018-02-06.csv,13,3,10,-2393.25,158723.25
BANKNIFTY08FEB1825700CE_2018-02-06.csv,10,5,5,-1516.5,54165.0
BANKNIFTY08FEB1825800CE_2018-02-06.csv,13,6,7,-1239.0,56478.75
BANKNIFTY08FEB1825900CE_2018-02-06.csv,10,3,7,-832.5,36066.0
BANKNIFTY08FEB1826000CE_2018-02-06.csv,6,2,4,-865.5,22882.5
BANKNIFTY08FEB1826100CE_2018-02-06.csv,7,4,3,-660.75,17602.5
BANKNIFTY08FEB1826200CE_2018-02-06.csv,13,7,6,-456.0,23277.0
BANKNIFTY08FEB1826300CE_2018-02-06.csv,13,7,6,-748.5,22161.75
BANKNIFTY08FEB1824400PE_2018-02-07.csv,32,19,13,311.25,10169.25
BANKNIFTY08FEB1824500PE_2018-02-07.csv,20,10,10,-270.75,7830.75
BANKNIFTY08FEB1824600PE_2018-02-07.csv,27,16,11,197.25,13305.75
BANKNIFTY08FEB1824700PE_2018-02-07.csv,22,12,10,-6.75,12578.25
BANKNIFTY08FEB1824800PE_2018-02-07.csv,22,10,12,-225.75,16832.25
BANKNIFTY08FEB1824900PE_2018-02-07.csv,26,12,14,-110.25,25967.25
BANKNIFTY08FEB1825000PE_2018-02-07.csv,15,7,8,156.0,18132.0
BANKNIFTY08FEB1825100PE_2018-02-07.csv,16,8,8,-135.0,24205.5
BANKNIFTY08FEB1825200PE_2018-02-07.csv,16,6,10,-336.75,27405.75
BANKNIFTY08FEB1825300PE_2018-02-07.csv,14,5,9,-318.75,30090.75
BANKNIFTY08FEB1825400PE_2018-02-07.csv,11,1,10,-1216.5,31708.5
BANKNIFTY08FEB1825500CE_2018-02-07.csv,17,4,13,-2373.75,178601.25
BANKNIFTY08FEB1825500PE_2018-02-07.csv,13,6,7,-204.75,45887.25
BANKNIFTY08FEB1825600CE_2018-02-07.csv,16,5,11,-1720.5,141130.5
BANKNIFTY08FEB1825600PE_2018-02-07.csv,10,1,9,-1609.5,48826.5
BANKNIFTY08FEB1825700CE_2018-02-07.csv,13,4,9,-1068.75,92067.75
BANKNIFTY08FEB1825700PE_2018-02-07.csv,10,5,5,335.25,52601.25
BANKNIFTY08FEB1825800CE_2018-02-07.csv,13,2,11,-1619.25,71007.75
BANKNIFTY08FEB1825800PE_2018-02-07.csv,11,4,7,126.0,74739.0
BANKNIFTY08FEB1825900CE_2018-02-07.csv,9,1,8,-856.5,34894.5
BANKNIFTY08FEB1825900PE_2018-02-07.csv,14,5,9,-570.75,126876.75
BANKNIFTY08FEB1826000CE_2018-02-07.csv,10,3,7,-559.5,27616.5
BANKNIFTY08FEB1826000PE_2018-02-07.csv,14,5,9,-572.25,152502.75
BANKNIFTY08FEB1826100CE_2018-02-07.csv,9,0,9,-1038.75,22767.75
BANKNIFTY08FEB1826200CE_2018-02-07.csv,10,1,9,-557.25,16650.75
BANKNIFTY08FEB1826300CE_2018-02-07.csv,13,2,11,-501.75,18159.0
BANKNIFTY08FEB1826400CE_2018-02-07.csv,11,0,11,-459.75,11163.75
BANKNIFTY08FEB1826500CE_2018-02-07.csv,12,3,9,-229.5,8493.0
BANKNIFTY08FEB1826600CE_2018-02-07.csv,19,9,10,27.75,11498.25
BANKNIFTY08FEB1826700CE_2018-02-07.csv,17,6,11,14.25,7313.25
BANKNIFTY08FEB1826800CE_2018-02-07.csv,21,7,14,-35.25,7633.5
BANKNIFTY08FEB1825000PE_2018-02-08.csv,59,36,23,-23.25,967.5
BANKNIFTY08FEB1825100PE_2018-02-08.csv,53,26,27,3.75,1038.0
BANKNIFTY08FEB1825200PE_2018-02-08.csv,49,25,24,18.0,1235.25
BANKNIFTY08FEB1825300PE_2018-02-08.csv,37,15,22,-11.25,1375.5
BANKNIFTY08FEB1825400PE_2018-02-08.csv,28,10,18,-36.0,1895.25
BANKNIFTY08FEB1825500CE_2018-02-08.csv,11,5,6,731.25,152996.25
BANKNIFTY08FEB1825500PE_2018-02-08.csv,21,8,13,-51.0,2613.75
BANKNIFTY08FEB1825600CE_2018-02-08.csv,14,7,7,810.75,135930.75
BANKNIFTY08FEB1825600PE_2018-02-08.csv,19,10,9,-112.5,4397.25
BANKNIFTY08FEB1825700CE_2018-02-08.csv,9,4,5,60.75,70595.25
BANKNIFTY08FEB1825700PE_2018-02-08.csv,14,5,9,-232.5,5571.75
BANKNIFTY08FEB1825800CE_2018-02-08.csv,13,8,5,758.25,63592.5
BANKNIFTY08FEB1825800PE_2018-02-08.csv,13,3,10,-429.75,12949.5
BANKNIFTY08FEB1825900CE_2018-02-08.csv,16,6,10,-799.5,41340.0
BANKNIFTY08FEB1825900PE_2018-02-08.csv,11,3,8,-680.25,21868.5
BANKNIFTY08FEB1826000CE_2018-02-08.csv,17,7,10,-547.5,20483.25
BANKNIFTY08FEB1826000PE_2018-02-08.csv,10,2,8,-1032.0,35871.0
BANKNIFTY08FEB1826100CE_2018-02-08.csv,23,12,11,23.25,10567.5
BANKNIFTY08FEB1826100PE_2018-02-08.csv,18,5,13,-2107.5,109488.0
BANKNIFTY08FEB1826200PE_2018-02-08.csv,20,8,12,-638.25,160562.25
BANKNIFTY15FEB1823800PE_2018-02-09.csv,26,13,13,79.5,21957.0
BANKNIFTY15FEB1824000PE_2018-02-09.csv,24,13,11,144.0,29271.0
BANKNIFTY15FEB1824100PE_2018-02-09.csv,24,10,14,84.0,35079.0
BANKNIFTY15FEB1824200PE_2018-02-09.csv,24,12,12,309.75,41786.25
BANKNIFTY15FEB1824300PE_2018-02-09.csv,21,11,10,302.25,41807.25
BANKNIFTY15FEB1824400PE_2018-02-09.csv,25,14,11,732.75,57713.25
BANKNIFTY15FEB1824500PE_2018-02-09.csv,17,8,9,78.0,47488.5
BANKNIFTY15FEB1824600PE_2018-02-09.csv,20,9,11,396.0,61415.25
BANKNIFTY15FEB1824700PE_2018-02-09.csv,16,7,9,-164.25,57267.0
BANKNIFTY15FEB1824800PE_2018-02-09.csv,15,6,9,-18.0,63336.0
BANKNIFTY15FEB1824900PE_2018-02-09.csv,12,5,7,-246.0,59249.25
BANKNIFTY15FEB1825000PE_2018-02-09.csv,12,7,5,915.0,67599.0
BANKNIFTY15FEB1825100PE_2018-02-09.csv,13,7,6,635.25,81643.5
BANKNIFTY15FEB1825200PE_2018-02-09.csv,12,5,7,-220.5,86613.0
BANKNIFTY15FEB1825300PE_2018-02-09.csv,10,4,6,284.25,82364.25
BANKNIFTY15FEB1825400PE_2018-02-09.csv,12,4,8,-735.0,111511.5
BANKNIFTY15FEB1825500CE_2018-02-09.csv,8,1,7,-1842.75,82085.25
BANKNIFTY15FEB1825500PE_2018-02-09.csv,10,3,7,-799.5,102691.5
BANKNIFTY15FEB1825600CE_2018-02-09.csv,12,3,9,-912.0,98059.5
BANKNIFTY15FEB1825700CE_2018-02-09.csv,12,3,9,-494.25,84515.25
BANKNIFTY15FEB1825800CE_2018-02-09.csv,10,2,8,-830.25,58577.25
BANKNIFTY15FEB1825900CE_2018-02-09.csv,11,2,9,-831.0,51735.0
BANKNIFTY15FEB1826000CE_2018-02-09.csv,9,2,7,-460.5,34443.0
BANKNIFTY15FEB1826100CE_2018-02-09.csv,12,5,7,126.0,36854.25
BANKNIFTY15FEB1826200CE_2018-02-09.csv,11,3,8,-300.0,26915.25
BANKNIFTY15FEB1826300CE_2018-02-09.csv,10,3,7,-128.25,19182.75
BANKNIFTY15FEB1826400CE_2018-02-09.csv,9,2,7,-126.0,13510.5
BANKNIFTY15FEB1826500CE_2018-02-09.csv,10,2,8,-181.5,10597.5
BANKNIFTY15FEB1826600CE_2018-02-09.csv,17,4,13,-224.25,15084.75
BANKNIFTY15FEB1826700CE_2018-02-09.csv,12,4,8,-64.5,8293.5
BANKNIFTY15FEB1824000PE_2018-02-12.csv,18,7,11,-99.0,4101.75
BANKNIFTY15FEB1824300PE_2018-02-12.csv,19,8,11,-161.25,7772.25
BANKNIFTY15FEB1824500PE_2018-02-12.csv,14,2,12,-180.0,7141.5
BANKNIFTY15FEB1824600PE_2018-02-12.csv,19,3,16,-270.75,12693.0
BANKNIFTY15FEB1824700PE_2018-02-12.csv,19,8,11,114.75,16447.5
BANKNIFTY15FEB1824800PE_2018-02-12.csv,13,4,9,-78.0,14145.75
BANKNIFTY15FEB1824900PE_2018-02-12.csv,10,3,7,-73.5,14207.25
BANKNIFTY15FEB1825000PE_2018-02-12.csv,8,2,6,-172.5,13273.5
BANKNIFTY15FEB1825100PE_2018-02-12.csv,12,3,9,-334.5,25164.0
BANKNIFTY15FEB1825200PE_2018-02-12.csv,13,4,9,-295.5,34930.5
BANKNIFTY15FEB1825300PE_2018-02-12.csv,13,4,9,-266.25,43286.25
BANKNIFTY15FEB1825400PE_2018-02-12.csv,8,1,7,-656.25,34047.75
BANKNIFTY15FEB1825500CE_2018-02-12.csv,7,2,5,-276.75,64695.75
BANKNIFTY15FEB1825500PE_2018-02-12.csv,10,1,9,-1170.0,51136.5
BANKNIFTY15FEB1825600CE_2018-02-12.csv,6,2,4,-54.75,46323.75
BANKNIFTY15FEB1825600PE_2018-02-12.csv,8,2,6,-588.0,53690.25
BANKNIFTY15FEB1825700CE_2018-02-12.csv,8,3,5,7.5,45882.0
BANKNIFTY15FEB1825700PE_2018-02-12.csv,11,3,8,-828.0,83929.5
BANKNIFTY15FEB1825800CE_2018-02-12.csv,7,1,6,-650.25,31050.75
BANKNIFTY15FEB1825800PE_2018-02-12.csv,13,4,9,-173.25,123944.25
BANKNIFTY15FEB1825900CE_2018-02-12.csv,7,1,6,-427.5,24564.0
BANKNIFTY15FEB1826000CE_2018-02-12.csv,7,1,6,-302.25,18803.25
BANKNIFTY15FEB1826100CE_2018-02-12.csv,6,1,5,-265.5,11254.5
BANKNIFTY15FEB1826200CE_2018-02-12.csv,8,1,7,-360.0,11826.0
BANKNIFTY15FEB1826300CE_2018-02-12.csv,8,3,5,-11.25,7721.25
BANKNIFTY15FEB1826400CE_2018-02-12.csv,11,2,9,-138.75,7659.75
BANKNIFTY15FEB1826500CE_2018-02-12.csv,14,5,9,-85.5,6913.5
BANKNIFTY15FEB1826700CE_2018-02-12.csv,19,7,12,-36.75,4986.75
BANKNIFTY15FEB1825100PE_2018-02-14.csv,12,5,7,72.0,9816.75
BANKNIFTY15FEB1825200PE_2018-02-14.csv,13,8,5,345.0,13125.0
BANKNIFTY15FEB1825300PE_2018-02-14.csv,13,6,7,116.25,22176.75
BANKNIFTY15FEB1825400CE_2018-02-14.csv,13,2,11,-1997.25,95177.25
BANKNIFTY15FEB1825400PE_2018-02-14.csv,9,4,5,-190.5,23481.0
BANKNIFTY15FEB1825500CE_2018-02-14.csv,10,2,8,-502.5,51277.5
BANKNIFTY15FEB1825500PE_2018-02-14.csv,9,3,6,-648.75,33494.25
BANKNIFTY15FEB1825600CE_2018-02-14.csv,10,0,10,-1297.5,31527.75
BANKNIFTY15FEB1825600PE_2018-02-14.csv,11,6,5,1260.75,59099.25
BANKNIFTY15FEB1825700CE_2018-02-14.csv,7,0,7,-518.25,15789.75
BANKNIFTY15FEB1825700PE_2018-02-14.csv,9,4,5,429.0,63018.75
BANKNIFTY15FEB1825800CE_2018-02-14.csv,12,2,10,-267.75,15812.25
BANKNIFTY15FEB1825800PE_2018-02-14.csv,11,7,4,2481.75,99102.75
BANKNIFTY15FEB1825900CE_2018-02-14.csv,14,5,9,-116.25,14093.25
BANKNIFTY15FEB1826000CE_2018-02-14.csv,14,2,12,-119.25,9167.25
BANKNIFTY15FEB1826000PE_2018-02-14.csv,11,5,6,1989.75,147803.25
BANKNIFTY15FEB1826100CE_2018-02-14.csv,14,1,13,-217.5,4917.0
BANKNIFTY15FEB1826200CE_2018-02-14.csv,15,2,13,5.25,3651.75
BANKNIFTY15FEB1825100PE_2018-02-15.csv,26,12,14,4.5,1875.75
BANKNIFTY15FEB1825200CE_2018-02-15.csv,20,7,13,-1128.75,144489.75
BANKNIFTY15FEB1825200PE_2018-02-15.csv,22,11,11,31.5,3045.75
BANKNIFTY15FEB1825300CE_2018-02-15.csv,14,3,11,-1768.5,68253.0
BANKNIFTY15FEB1825300PE_2018-02-15.csv,15,8,7,16.5,5220.75
BANKNIFTY15FEB1825400CE_2018-02-15.csv,12,4,8,-402.75,27992.25
BANKNIFTY15FEB1825400PE_2018-02-15.csv,14,6,8,48.0,11532.75
BANKNIFTY15FEB1825500CE_2018-02-15.csv,14,6,8,-573.0,15413.25
BANKNIFTY15FEB1825500PE_2018-02-15.csv,8,4,4,9.75,20255.25
BANKNIFTY15FEB1825600CE_2018-02-15.csv,22,9,13,-120.0,5550.75
BANKNIFTY15FEB1825600PE_2018-02-15.csv,15,5,10,-558.0,70344.0
BANKNIFTY15FEB1825700PE_2018-02-15.csv,13,7,6,1381.5,99405.0
BANKNIFTY22FEB1824200PE_2018-02-16.csv,28,15,13,313.5,21837.0
BANKNIFTY22FEB1824300PE_2018-02-16.csv,23,12,11,201.0,22521.0
BANKNIFTY22FEB1824400PE_2018-02-16.csv,22,11,11,435.0,26905.5
BANKNIFTY22FEB1824500PE_2018-02-16.csv,16,10,6,571.5,23337.0
BANKNIFTY22FEB1824600PE_2018-02-16.csv,21,13,8,880.5,34836.0
BANKNIFTY22FEB1824700PE_2018-02-16.csv,19,12,7,928.5,36781.5
BANKNIFTY22FEB1824800PE_2018-02-16.csv,15,10,5,1169.25,38753.25
BANKNIFTY22FEB1824900PE_2018-02-16.csv,16,10,6,996.0,49369.5
BANKNIFTY22FEB1825000PE_2018-02-16.csv,13,10,3,1972.5,49848.0
BANKNIFTY22FEB1825100PE_2018-02-16.csv,12,7,5,896.25,55734.0
BANKNIFTY22FEB1825200PE_2018-02-16.csv,12,8,4,1789.5,68690.25
BANKNIFTY22FEB1825300CE_2018-02-16.csv,12,1,11,-2500.5,97713.0
BANKNIFTY22FEB1825300PE_2018-02-16.csv,7,3,4,155.25,49362.75
BANKNIFTY22FEB1825400CE_2018-02-16.csv,11,1,10,-2195.25,76424.25
BANKNIFTY22FEB1825400PE_2018-02-16.csv,10,5,5,1154.25,80448.75
BANKNIFTY22FEB1825500CE_2018-02-16.csv,8,1,7,-930.0,41142.0
BANKNIFTY22FEB1825500PE_2018-02-16.csv,11,6,5,1656.75,106388.25
BANKNIFTY22FEB1825600CE_2018-02-16.csv,7,1,6,-729.0,28206.0
BANKNIFTY22FEB1825600PE_2018-02-16.csv,10,6,4,2609.25,122409.75
BANKNIFTY22FEB1825700CE_2018-02-16.csv,13,1,12,-1012.5,32700.0
BANKNIFTY22FEB1825800CE_2018-02-16.csv,14,3,11,-577.5,29295.0
BANKNIFTY22FEB1825900CE_2018-02-16.csv,14,2,12,-616.5,20820.0
BANKNIFTY22FEB1826000CE_2018-02-16.csv,10,2,8,-264.0,11586.0
BANKNIFTY22FEB1826100CE_2018-02-16.csv,16,2,14,-323.25,12484.5
BANKNIFTY22FEB1826200CE_2018-02-16.csv,16,2,14,-215.25,8337.75
BANKNIFTY22FEB1824000PE_2018-02-19.csv,20,8,12,0.75,12983.25
BANKNIFTY22FEB1824100PE_2018-02-19.csv,24,10,14,29.25,19890.75
BANKNIFTY22FEB1824200PE_2018-02-19.csv,21,11,10,222.0,21562.5
BANKNIFTY22FEB1824300PE_2018-02-19.csv,13,2,11,-366.0,16335.0
BANKNIFTY22FEB1824400PE_2018-02-19.csv,13,4,9,-237.75,21903.75
BANKNIFTY22FEB1824500PE_2018-02-19.csv,13,4,9,-199.5,27520.5
BANKNIFTY22FEB1824600PE_2018-02-19.csv,17,5,12,-279.0,44266.5
BANKNIFTY22FEB1824700PE_2018-02-19.csv,13,3,10,-569.25,42910.5
BANKNIFTY22FEB1824800CE_2018-02-19.csv,16,6,10,-586.5,146338.5
BANKNIFTY22FEB1824800PE_2018-02-19.csv,9,1,8,-960.75,39602.25
BANKNIFTY22FEB1824900CE_2018-02-19.csv,13,4,9,-1833.75,104142.75
BANKNIFTY22FEB1824900PE_2018-02-19.csv,11,1,10,-1295.25,58241.25
BANKNIFTY22FEB1825000CE_2018-02-19.csv,9,4,5,9.75,51561.75
BANKNIFTY22FEB1825000PE_2018-02-19.csv,10,3,7,-492.0,68860.5
BANKNIFTY22FEB1825100CE_2018-02-19.csv,8,1,7,-795.75,33695.25
BANKNIFTY22FEB1825100PE_2018-02-19.csv,10,2,8,-1388.25,82391.25
BANKNIFTY22FEB1825200CE_2018-02-19.csv,13,4,9,-359.25,40182.75
BANKNIFTY22FEB1825200PE_2018-02-19.csv,9,3,6,-669.0,89283.0
BANKNIFTY22FEB1825300CE_2018-02-19.csv,12,4,8,-180.0,29109.0
BANKNIFTY22FEB1825300PE_2018-02-19.csv,13,6,7,1239.75,156333.75
BANKNIFTY22FEB1825400CE_2018-02-19.csv,12,6,6,169.5,17013.0
BANKNIFTY22FEB1825400PE_2018-02-19.csv,11,3,8,-1483.5,157665.0
BANKNIFTY22FEB1825500CE_2018-02-19.csv,9,2,7,-204.0,10485.0
BANKNIFTY22FEB1825600CE_2018-02-19.csv,16,6,10,-5.25,12683.25
BANKNIFTY22FEB1825700CE_2018-02-19.csv,12,5,7,42.75,6716.25
BANKNIFTY22FEB1825800CE_2018-02-19.csv,16,6,10,21.0,6282.0
BANKNIFTY22FEB1824400PE_2018-02-20.csv,18,8,10,61.5,12259.5
BANKNIFTY22FEB1824500PE_2018-02-20.csv,12,6,6,143.25,11280.75
BANKNIFTY22FEB1824600PE_2018-02-20.csv,16,8,8,39.75,20844.75
BANKNIFTY22FEB1824700PE_2018-02-20.csv,8,2,6,-303.75,14436.75
BANKNIFTY22FEB1824800CE_2018-02-20.csv,13,4,9,-437.25,127968.75
BANKNIFTY22FEB1824800PE_2018-02-20.csv,13,6,7,201.0,33109.5
BANKNIFTY22FEB1824900CE_2018-02-20.csv,16,5,11,-894.75,119966.25
BANKNIFTY22FEB1824900PE_2018-02-20.csv,11,3,8,-343.5,35106.0
BANKNIFTY22FEB1825000CE_2018-02-20.csv,10,3,7,-583.5,59343.0
BANKNIFTY22FEB1825000PE_2018-02-20.csv,10,3,7,-363.75,41519.25
BANKNIFTY22FEB1825100CE_2018-02-20.csv,15,5,10,-245.25,61941.0
BANKNIFTY22FEB1825100PE_2018-02-20.csv,10,4,6,72.0,57447.0
BANKNIFTY22FEB1825200CE_2018-02-20.csv,15,6,9,134.25,44831.25
BANKNIFTY22FEB1825200PE_2018-02-20.csv,15,3,12,-1797.75,109298.25
BANKNIFTY22FEB1825300CE_2018-02-20.csv,12,6,6,391.5,24412.5
BANKNIFTY22FEB1825300PE_2018-02-20.csv,17,6,11,245.25,160071.75
BANKNIFTY22FEB1825400CE_2018-02-20.csv,15,6,9,73.5,20862.0
BANKNIFTY22FEB1825500CE_2018-02-20.csv,19,6,13,-82.5,16620.0
BANKNIFTY22FEB1825600CE_2018-02-20.csv,16,6,10,15.0,9588.0
BANKNIFTY22FEB1824300PE_2018-02-21.csv,25,12,13,42.0,10729.5
BANKNIFTY22FEB1824400PE_2018-02-21.csv,17,6,11,-108.75,10665.75
BANKNIFTY22FEB1824500PE_2018-02-21.csv,13,4,9,-153.0,12110.25
BANKNIFTY22FEB1824600PE_2018-02-21.csv,13,6,7,-16.5,17110.5
BANKNIFTY22FEB1824700CE_2018-02-21.csv,13,5,8,-175.5,93599.25
BANKNIFTY22FEB1824700PE_2018-02-21.csv,8,3,5,-326.25,16128.75
BANKNIFTY22FEB1824800CE_2018-02-21.csv,8,3,5,-315.0,39292.5
BANKNIFTY22FEB1824800PE_2018-02-21.csv,10,4,6,-90.0,29184.0
BANKNIFTY22FEB1824900CE_2018-02-21.csv,9,3,6,-392.25,33070.5
BANKNIFTY22FEB1824900PE_2018-02-21.csv,9,2,7,-490.5,34357.5
BANKNIFTY22FEB1825000CE_2018-02-21.csv,5,1,4,-205.5,12385.5
BANKNIFTY22FEB1825000PE_2018-02-21.csv,11,2,9,-1332.75,63402.75
BANKNIFTY22FEB1825100CE_2018-02-21.csv,9,3,6,-283.5,12909.0
BANKNIFTY22FEB1825100PE_2018-02-21.csv,11,4,7,-345.75,90035.25
BANKNIFTY22FEB1825200CE_2018-02-21.csv,8,4,4,84.75,6659.25
BANKNIFTY22FEB1825200PE_2018-02-21.csv,12,5,7,102.75,127356.75
BANKNIFTY22FEB1825300CE_2018-02-21.csv,14,5,9,-89.25,7227.75
BANKNIFTY22FEB1824600CE_2018-02-22.csv,11,6,5,1337.25,89027.25
BANKNIFTY22FEB1824600PE_2018-02-22.csv,19,5,14,-69.0,3387.75
BANKNIFTY22FEB1824700CE_2018-02-22.csv,5,2,3,-405.75,23997.75
BANKNIFTY22FEB1824700PE_2018-02-22.csv,17,5,12,-147.75,7185.0
BANKNIFTY22FEB1824800CE_2018-02-22.csv,9,3,6,-225.0,24864.0
BANKNIFTY22FEB1824800PE_2018-02-22.csv,14,5,9,-248.25,13725.0
BANKNIFTY22FEB1824900CE_2018-02-22.csv,8,3,5,-96.75,10514.25
BANKNIFTY22FEB1824900PE_2018-02-22.csv,11,3,8,-276.75,18385.5
BANKNIFTY22FEB1825000CE_2018-02-22.csv,13,4,9,-98.25,5722.5
BANKNIFTY22FEB1825000PE_2018-02-22.csv,12,3,9,-1005.0,57916.5
BANKNIFTY22FEB1825100PE_2018-02-22.csv,13,5,8,-89.25,94803.75
BANKNIFTY01MAR1824200PE_2018-02-23.csv,9,1,8,-117.75,4085.25
BANKNIFTY01MAR1824300PE_2018-02-23.csv,8,1,7,-98.25,4076.25
BANKNIFTY01MAR1824400PE_2018-02-23.csv,11,2,9,-190.5,7669.5
BANKNIFTY01MAR1824500PE_2018-02-23.csv,9,0,9,-318.0,7742.25
BANKNIFTY01MAR1824600PE_2018-02-23.csv,8,0,8,-323.25,8074.5
BANKNIFTY01MAR1824700PE_2018-02-23.csv,8,0,8,-378.0,9498.0
BANKNIFTY01MAR1824800PE_2018-02-23.csv,11,1,10,-612.75,18236.25
BANKNIFTY01MAR1824900CE_2018-02-23.csv,7,4,3,1694.25,86824.5
BANKNIFTY01MAR1824900PE_2018-02-23.csv,7,0,7,-500.25,13875.75
BANKNIFTY01MAR1825000CE_2018-02-23.csv,6,4,2,1914.75,58325.25
BANKNIFTY01MAR1825000PE_2018-02-23.csv,10,1,9,-882.0,26586.0
BANKNIFTY01MAR1825100CE_2018-02-23.csv,7,5,2,1625.25,52871.25
BANKNIFTY01MAR1825100PE_2018-02-23.csv,8,0,8,-1079.25,26045.25
BANKNIFTY01MAR1825200CE_2018-02-23.csv,7,5,2,1134.75,40064.25
BANKNIFTY01MAR1825200PE_2018-02-23.csv,8,0,8,-1476.75,41166.75
BANKNIFTY01MAR1825300CE_2018-02-23.csv,7,4,3,486.0,29394.0
BANKNIFTY01MAR1825300PE_2018-02-23.csv,10,0,10,-2382.75,66471.75
BANKNIFTY01MAR1825400CE_2018-02-23.csv,12,6,6,331.5,34603.5
BANKNIFTY01MAR1825500CE_2018-02-23.csv,13,7,6,436.5,27438.0
BANKNIFTY01MAR1825500PE_2018-02-23.csv,11,1,10,-3324.75,113909.25
BANKNIFTY01MAR1825600CE_2018-02-23.csv,9,6,3,357.75,14423.25
BANKNIFTY01MAR1825700CE_2018-02-23.csv,12,4,8,-4.5,12564.0
BANKNIFTY01MAR1825800CE_2018-02-23.csv,11,7,4,200.25,7938.75
BANKNIFTY01MAR1824900PE_2018-02-26.csv,6,0,6,-110.25,3410.25
BANKNIFTY01MAR1825000PE_2018-02-26.csv,5,0,5,-131.25,4281.75
BANKNIFTY01MAR1825100PE_2018-02-26.csv,6,0,6,-176.25,5846.25
BANKNIFTY01MAR1825200CE_2018-02-26.csv,4,2,2,693.0,54856.5
BANKNIFTY01MAR1825200PE_2018-02-26.csv,8,1,7,-251.25,8967.75
BANKNIFTY01MAR1825300CE_2018-02-26.csv,6,3,3,751.5,62935.5
BANKNIFTY01MAR1825300PE_2018-02-26.csv,7,0,7,-383.25,11553.75
BANKNIFTY01MAR1825400CE_2018-02-26.csv,5,3,2,660.75,43116.0
BANKNIFTY01MAR1825400PE_2018-02-26.csv,10,0,10,-751.5,22158.0
BANKNIFTY01MAR1825500CE_2018-02-26.csv,6,3,3,349.5,35769.75
BANKNIFTY01MAR1825500PE_2018-02-26.csv,8,0,8,-869.25,23739.75
BANKNIFTY01MAR1825600CE_2018-02-26.csv,8,4,4,79.5,30769.5
BANKNIFTY01MAR1825600PE_2018-02-26.csv,9,0,9,-1632.75,43758.75
BANKNIFTY01MAR1825700CE_2018-02-26.csv,5,3,2,225.75,14841.0
BANKNIFTY01MAR1825700PE_2018-02-26.csv,7,1,6,-816.75,56367.75
BANKNIFTY01MAR1825800CE_2018-02-26.csv,7,3,4,13.5,13146.0
BANKNIFTY01MAR1825800PE_2018-02-26.csv,11,2,9,-1692.0,95620.5
BANKNIFTY01MAR1825900CE_2018-02-26.csv,9,6,3,395.25,11693.25
BANKNIFTY01MAR1825000PE_2018-02-27.csv,11,4,7,-10.5,9019.5
BANKNIFTY01MAR1825100PE_2018-02-27.csv,12,3,9,-87.75,13353.75
BANKNIFTY01MAR1825200CE_2018-02-27.csv,14,3,11,-2700.75,137772.75
BANKNIFTY01MAR1825200PE_2018-02-27.csv,8,5,3,279.0,13228.5
BANKNIFTY01MAR1825300CE_2018-02-27.csv,10,3,7,-637.5,72937.5
BANKNIFTY01MAR1825300PE_2018-02-27.csv,10,4,6,79.5,22375.5
BANKNIFTY01MAR1825400CE_2018-02-27.csv,11,3,8,-770.25,60626.25
BANKNIFTY01MAR1825400PE_2018-02-27.csv,9,4,5,114.75,30584.25
BANKNIFTY01MAR1825500CE_2018-02-27.csv,7,3,4,-312.0,27609.75
BANKNIFTY01MAR1825500PE_2018-02-27.csv,10,5,5,598.5,44560.5
BANKNIFTY01MAR1825600CE_2018-02-27.csv,10,3,7,-519.0,26256.0
BANKNIFTY01MAR1825600PE_2018-02-27.csv,8,3,5,-45.0,49530.0
BANKNIFTY01MAR1825700CE_2018-02-27.csv,6,2,4,21.75,7905.75
BANKNIFTY01MAR1825700PE_2018-02-27.csv,7,2,5,-464.25,62637.0
BANKNIFTY01MAR1825800CE_2018-02-27.csv,8,4,4,123.75,8750.25
BANKNIFTY01MAR1825800PE_2018-02-27.csv,10,5,5,1090.5,112116.0
BANKNIFTY01MAR1825900CE_2018-02-27.csv,9,3,6,-9.75,5777.25
BANKNIFTY01MAR1826000CE_2018-02-27.csv,14,5,9,-48.75,6941.25
BANKNIFTY01MAR1824600PE_2018-02-28.csv,16,8,8,48.0,4896.0
BANKNIFTY01MAR1824700PE_2018-02-28.csv,14,6,8,20.25,6365.25
BANKNIFTY01MAR1824800CE_2018-02-28.csv,13,6,7,1977.0,114208.5
BANKNIFTY01MAR1824800PE_2018-02-28.csv,13,4,9,-211.5,10810.5
BANKNIFTY01MAR1824900CE_2018-02-28.csv,13,3,10,-523.5,82182.0
BANKNIFTY01MAR1824900PE_2018-02-28.csv,10,2,8,-310.5,13399.5
BANKNIFTY01MAR1825000CE_2018-02-28.csv,8,0,8,-1280.25,29121.75
BANKNIFTY01MAR1825000PE_2018-02-28.csv,11,3,8,-556.5,23902.5
BANKNIFTY01MAR1825100CE_2018-02-28.csv,8,1,7,-669.0,17719.5
BANKNIFTY01MAR1825100PE_2018-02-28.csv,10,4,6,-165.0,35253.0
BANKNIFTY01MAR1825200CE_2018-02-28.csv,11,0,11,-840.0,15490.5
BANKNIFTY01MAR1825200PE_2018-02-28.csv,9,3,6,-807.0,51471.0
BANKNIFTY01MAR1825300CE_2018-02-28.csv,9,2,7,-196.5,6654.0
BANKNIFTY01MAR1825300PE_2018-02-28.csv,11,4,7,-630.0,84608.25
BANKNIFTY01MAR1825400CE_2018-02-28.csv,11,3,8,-69.0,4509.0
BANKNIFTY01MAR1825400PE_2018-02-28.csv,11,2,9,-2397.75,113064.75
BANKNIFTY01MAR1824800CE_2018-03-01.csv,20,9,11,850.5,170328.0
BANKNIFTY01MAR1824900CE_2018-03-01.csv,16,7,9,311.25,84896.25
BANKNIFTY01MAR1824900PE_2018-03-01.csv,20,8,12,-28.5,2868.0
BANKNIFTY01MAR1825000CE_2018-03-01.csv,18,9,9,-11.25,49362.0
BANKNIFTY01MAR1825000PE_2018-03-01.csv,12,4,8,-35.25,6701.25
BANKNIFTY01MAR1825100CE_2018-03-01.csv,15,6,9,-153.75,18481.5
BANKNIFTY01MAR1825100PE_2018-03-01.csv,13,6,7,103.5,17512.5
BANKNIFTY01MAR1825200CE_2018-03-01.csv,22,11,11,95.25,9148.5
BANKNIFTY01MAR1825200PE_2018-03-01.csv,11,3,8,-461.25,34571.25
BANKNIFTY01MAR1825300CE_2018-03-01.csv,24,10,14,8.25,2769.0
BANKNIFTY01MAR1825300PE_2018-03-01.csv,11,5,6,1092.75,61781.25
BANKNIFTY01MAR1825400PE_2018-03-01.csv,13,4,9,-435.0,118680.0
BANKNIFTY01MAR1825500PE_2018-03-01.csv,11,4,7,313.5,136926.75
BANKNIFTY08MAR1823800PE_2018-03-05.csv,20,8,12,-5.25,10458.75
BANKNIFTY08MAR1823900PE_2018-03-05.csv,18,7,11,-36.0,12874.5
BANKNIFTY08MAR1824000PE_2018-03-05.csv,11,4,7,-12.0,10923.0
BANKNIFTY08MAR1824100PE_2018-03-05.csv,12,5,7,-25.5,15547.5
BANKNIFTY08MAR1824200PE_2018-03-05.csv,11,5,6,65.25,18456.75
BANKNIFTY08MAR1824300PE_2018-03-05.csv,6,3,3,120.75,13650.75
BANKNIFTY08MAR1824400PE_2018-03-05.csv,8,3,5,-72.75,23166.75
BANKNIFTY08MAR1824500PE_2018-03-05.csv,8,4,4,171.75,28101.75
BANKNIFTY08MAR1824600CE_2018-03-05.csv,10,4,6,719.25,94791.75
BANKNIFTY08MAR1824600PE_2018-03-05.csv,7,3,4,-22.5,30273.0
BANKNIFTY08MAR1824700CE_2018-03-05.csv,6,5,1,2010.75,48727.5
BANKNIFTY08MAR1824700PE_2018-03-05.csv,8,3,5,-91.5,45897.0
BANKNIFTY08MAR1824800CE_2018-03-05.csv,6,4,2,1024.5,33678.0
BANKNIFTY08MAR1824800PE_2018-03-05.csv,7,2,5,-444.75,50853.0
BANKNIFTY08MAR1824900CE_2018-03-05.csv,6,3,3,336.75,27876.75
BANKNIFTY08MAR1824900PE_2018-03-05.csv,6,1,5,-969.0,52854.0
BANKNIFTY08MAR1825000CE_2018-03-05.csv,7,4,3,414.75,21884.25
BANKNIFTY08MAR1825000PE_2018-03-05.csv,8,3,5,-148.5,83739.75
BANKNIFTY08MAR1825100CE_2018-03-05.csv,6,2,4,62.25,14787.75
BANKNIFTY08MAR1825200CE_2018-03-05.csv,6,3,3,141.0,10434.0
BANKNIFTY08MAR1825300CE_2018-03-05.csv,8,4,4,205.5,9459.75
BANKNIFTY08MAR1825400CE_2018-03-05.csv,9,4,5,66.75,6416.25
BANKNIFTY08MAR1824200PE_2018-03-06.csv,18,13,5,339.0,8985.0
BANKNIFTY08MAR1824300PE_2018-03-06.csv,12,5,7,48.75,8915.25
BANKNIFTY08MAR1824400PE_2018-03-06.csv,15,10,5,492.0,16165.5
BANKNIFTY08MAR1824500PE_2018-03-06.csv,11,8,3,647.25,16937.25
BANKNIFTY08MAR1824600CE_2018-03-06.csv,13,3,10,-1945.5,130243.5
BANKNIFTY08MAR1824600PE_2018-03-06.csv,9,5,4,261.75,19025.25
BANKNIFTY08MAR1824700CE_2018-03-06.csv,13,1,12,-3069.75,105826.5
BANKNIFTY08MAR1824700PE_2018-03-06.csv,8,6,2,1183.5,23598.0
BANKNIFTY08MAR1824800CE_2018-03-06.csv,7,2,5,-268.5,45453.75
BANKNIFTY08MAR1824800PE_2018-03-06.csv,10,5,5,648.75,34661.25
BANKNIFTY08MAR1824900CE_2018-03-06.csv,9,1,8,-1257.75,41561.25
BANKNIFTY08MAR1824900PE_2018-03-06.csv,9,4,5,454.5,43695.0
BANKNIFTY08MAR1825000CE_2018-03-06.csv,11,2,9,-671.25,35213.25
BANKNIFTY08MAR1825000PE_2018-03-06.csv,6,4,2,1035.75,39900.75
BANKNIFTY08MAR1825100CE_2018-03-06.csv,11,2,9,-651.0,25437.0
BANKNIFTY08MAR1825100PE_2018-03-06.csv,14,8,6,2853.0,129819.0
BANKNIFTY08MAR1825200CE_2018-03-06.csv,12,3,9,-306.0,21625.5
BANKNIFTY08MAR1825200PE_2018-03-06.csv,12,7,5,3053.25,138416.25
BANKNIFTY08MAR1825300CE_2018-03-06.csv,11,2,9,-319.5,11166.0
BANKNIFTY08MAR1825400CE_2018-03-06.csv,16,5,11,-11.25,9216.75
BANKNIFTY08MAR1823800PE_2018-03-07.csv,13,6,7,43.5,9784.5
BANKNIFTY08MAR1823900PE_2018-03-07.csv,16,10,6,354.0,17958.0
BANKNIFTY08MAR1824000CE_2018-03-07.csv,15,4,11,-1830.75,127868.25
BANKNIFTY08MAR1824000PE_2018-03-07.csv,10,4,6,-53.25,17105.25
BANKNIFTY08MAR1824100CE_2018-03-07.csv,17,6,11,-975.75,118512.75
BANKNIFTY08MAR1824100PE_2018-03-07.csv,11,6,5,195.75,28882.5
BANKNIFTY08MAR1824200CE_2018-03-07.csv,8,4,4,342.0,39088.5
BANKNIFTY08MAR1824200PE_2018-03-07.csv,12,6,6,383.25,45079.5
BANKNIFTY08MAR1824300CE_2018-03-07.csv,9,5,4,355.5,30856.5
BANKNIFTY08MAR1824300PE_2018-03-07.csv,13,8,5,911.25,64229.25
BANKNIFTY08MAR1824400CE_2018-03-07.csv,8,4,4,41.25,19161.75
BANKNIFTY08MAR1824400PE_2018-03-07.csv,15,8,7,1094.25,104322.75
BANKNIFTY08MAR1824500CE_2018-03-07.csv,8,3,5,-288.75,11418.75
BANKNIFTY08MAR1824500PE_2018-03-07.csv,10,5,5,703.5,94050.0
BANKNIFTY08MAR1824600CE_2018-03-07.csv,13,6,7,-123.75,8103.75
BANKNIFTY08MAR1824600PE_2018-03-07.csv,16,7,9,771.0,181014.75
BANKNIFTY08MAR1824700CE_2018-03-07.csv,5,1,4,-39.0,1305.0
BANKNIFTY08MAR1823900CE_2018-03-08.csv,22,7,15,-1272.0,234516.0
BANKNIFTY08MAR1824000CE_2018-03-08.csv,13,5,8,-294.0,113571.0
BANKNIFTY08MAR1824000PE_2018-03-08.csv,29,16,13,-33.75,6952.5
BANKNIFTY08MAR1824100CE_2018-03-08.csv,14,6,8,78.0,82174.5
BANKNIFTY08MAR1824100PE_2018-03-08.csv,24,13,11,-140.25,14325.0
BANKNIFTY08MAR1824200CE_2018-03-08.csv,16,7,9,163.5,53961.0
BANKNIFTY08MAR1824200PE_2018-03-08.csv,20,11,9,8.25,25954.5
BANKNIFTY08MAR1824300CE_2018-03-08.csv,14,7,7,-166.5,23106.0
BANKNIFTY08MAR1824300PE_2018-03-08.csv,13,5,8,-638.25,36205.5
BANKNIFTY08MAR1824400PE_2018-03-08.csv,15,8,7,306.75,72366.0
BANKNIFTY08MAR1824500PE_2018-03-08.csv,12,3,9,-741.75,99629.25
BANKNIFTY08MAR1824600PE_2018-03-08.csv,15,4,11,-2485.5,141655.5
BANKNIFTY15MAR1823400PE_2018-03-09.csv,18,8,10,66.0,12393.0
BANKNIFTY15MAR1823500PE_2018-03-09.csv,19,11,8,285.75,17372.25
BANKNIFTY15MAR1823600PE_2018-03-09.csv,15,9,6,290.25,17481.75
BANKNIFTY15MAR1823700PE_2018-03-09.csv,16,7,9,166.5,23779.5
BANKNIFTY15MAR1823800PE_2018-03-09.csv,13,6,7,158.25,23441.25
BANKNIFTY15MAR1823900PE_2018-03-09.csv,11,4,7,-12.75,25344.75
BANKNIFTY15MAR1824000PE_2018-03-09.csv,13,8,5,761.25,37208.25
BANKNIFTY15MAR1824100PE_2018-03-09.csv,13,8,5,966.0,46189.5
BANKNIFTY15MAR1824200PE_2018-03-09.csv,14,6,8,319.5,66051.75
BANKNIFTY15MAR1824300CE_2018-03-09.csv,16,3,13,-2244.75,142539.75
BANKNIFTY15MAR1824300PE_2018-03-09.csv,9,2,7,-836.25,48275.25
BANKNIFTY15MAR1824400CE_2018-03-09.csv,9,0,9,-2245.5,61381.5
BANKNIFTY15MAR1824400PE_2018-03-09.csv,11,4,7,-181.5,74913.0
BANKNIFTY15MAR1824500CE_2018-03-09.csv,11,1,10,-1604.25,59577.75
BANKNIFTY15MAR1824500PE_2018-03-09.csv,7,3,4,248.25,60464.25
BANKNIFTY15MAR1824600CE_2018-03-09.csv,11,3,8,-485.25,45846.75
BANKNIFTY15MAR1824600PE_2018-03-09.csv,8,3,5,-303.75,84393.75
BANKNIFTY15MAR1824700CE_2018-03-09.csv,14,4,10,-291.0,45246.0
BANKNIFTY15MAR1824800CE_2018-03-09.csv,16,4,12,-451.5,39340.5
BANKNIFTY15MAR1824900CE_2018-03-09.csv,15,6,9,-0.75,26090.25
BANKNIFTY15MAR1825000CE_2018-03-09.csv,13,3,10,-157.5,15591.0
BANKNIFTY15MAR1825100CE_2018-03-09.csv,14,5,9,18.75,11951.25
BANKNIFTY15MAR1823600PE_2018-03-12.csv,17,7,10,17.25,10964.25
BANKNIFTY15MAR1823700PE_2018-03-12.csv,13,5,8,0.0,11365.5
BANKNIFTY15MAR1823800PE_2018-03-12.csv,10,3,7,-114.0,11251.5
BANKNIFTY15MAR1823900PE_2018-03-12.csv,11,3,8,-243.75,17048.25
BANKNIFTY15MAR1824000PE_2018-03-12.csv,9,3,6,-237.0,18693.0
BANKNIFTY15MAR1824100PE_2018-03-12.csv,8,3,5,27.75,20732.25
BANKNIFTY15MAR1824200PE_2018-03-12.csv,8,2,6,-494.25,28050.75
BANKNIFTY15MAR1824300CE_2018-03-12.csv,9,6,3,2519.25,93966.75
BANKNIFTY15MAR1824300PE_2018-03-12.csv,6,1,5,-596.25,25484.25
BANKNIFTY15MAR1824400CE_2018-03-12.csv,10,6,4,1667.25,73988.25
BANKNIFTY15MAR1824400PE_2018-03-12.csv,8,2,6,-765.75,44459.25
BANKNIFTY15MAR1824500CE_2018-03-12.csv,9,4,5,417.0,51751.5
BANKNIFTY15MAR1824500PE_2018-03-12.csv,8,2,6,-942.0,53451.0
BANKNIFTY15MAR1824600CE_2018-03-12.csv,7,4,3,588.75,31010.25
BANKNIFTY15MAR1824600PE_2018-03-12.csv,10,3,7,-357.0,81090.0
BANKNIFTY15MAR1824700CE_2018-03-12.csv,7,5,2,755.25,25656.0
BANKNIFTY15MAR1824800CE_2018-03-12.csv,8,3,5,34.5,19528.5
BANKNIFTY15MAR1824900CE_2018-03-12.csv,11,6,5,339.0,18333.0
BANKNIFTY15MAR1825000CE_2018-03-12.csv,10,6,4,219.75,12399.0
BANKNIFTY15MAR1825100CE_2018-03-12.csv,12,5,7,10.5,8943.0
BANKNIFTY15MAR1824000PE_2018-03-13.csv,10,3,7,-121.5,5383.5
BANKNIFTY15MAR1824100PE_2018-03-13.csv,11,3,8,-121.5,7900.5
BANKNIFTY15MAR1824200PE_2018-03-13.csv,12,3,9,-39.0,9732.0
BANKNIFTY15MAR1824300PE_2018-03-13.csv,11,3,8,-230.25,14538.75
BANKNIFTY15MAR1824400PE_2018-03-13.csv,9,2,7,-371.25,13283.25
BANKNIFTY15MAR1824500CE_2018-03-13.csv,10,6,4,1376.25,116093.25
BANKNIFTY15MAR1824500PE_2018-03-13.csv,10,4,6,-187.5,16999.5
BANKNIFTY15MAR1824600CE_2018-03-13.csv,9,3,6,-138.0,103012.5
BANKNIFTY15MAR1824600PE_2018-03-13.csv,11,3,8,-424.5,24589.5
BANKNIFTY15MAR1824700CE_2018-03-13.csv,7,3,4,427.5,67183.5
BANKNIFTY15MAR1824700PE_2018-03-13.csv,8,2,6,-330.75,28538.25
BANKNIFTY15MAR1824800CE_2018-03-13.csv,8,3,5,329.25,59859.75
BANKNIFTY15MAR1824800PE_2018-03-13.csv,7,2,5,-475.5,32919.0
BANKNIFTY15MAR1824900CE_2018-03-13.csv,9,2,7,-564.75,50475.75
BANKNIFTY15MAR1824900PE_2018-03-13.csv,9,2,7,-726.75,57731.25
BANKNIFTY15MAR1825000CE_2018-03-13.csv,10,2,8,-760.5,39036.0
BANKNIFTY15MAR1825000PE_2018-03-13.csv,9,3,6,113.25,73494.75
BANKNIFTY15MAR1825100CE_2018-03-13.csv,10,3,7,-325.5,28126.5
BANKNIFTY15MAR1825100PE_2018-03-13.csv,14,4,10,-3983.25,130395.75
BANKNIFTY15MAR1825200CE_2018-03-13.csv,9,2,7,-487.5,16317.0
BANKNIFTY15MAR1825200PE_2018-03-13.csv,17,7,10,-600.75,197383.5
BANKNIFTY15MAR1825300CE_2018-03-13.csv,10,4,6,-64.5,11776.5
BANKNIFTY15MAR1825400CE_2018-03-13.csv,13,5,8,-138.0,9708.0
BANKNIFTY15MAR1825500CE_2018-03-13.csv,14,6,8,-62.25,8217.75
BANKNIFTY15MAR1823900PE_2018-03-14.csv,23,9,14,11.25,6662.25
BANKNIFTY15MAR1824000PE_2018-03-14.csv,14,5,9,-36.75,5013.75
BANKNIFTY15MAR1824100PE_2018-03-14.csv,14,9,5,150.75,9478.5
BANKNIFTY15MAR1824200PE_2018-03-14.csv,14,8,6,167.25,12830.25
BANKNIFTY15MAR1824300CE_2018-03-14.csv,12,5,7,360.75,136485.0
BANKNIFTY15MAR1824300PE_2018-03-14.csv,11,7,4,277.5,12961.5
BANKNIFTY15MAR1824400CE_2018-03-14.csv,16,6,10,628.5,144243.75
BANKNIFTY15MAR1824400PE_2018-03-14.csv,11,6,5,331.5,22749.75
BANKNIFTY15MAR1824500CE_2018-03-14.csv,10,6,4,2281.5,79900.5
BANKNIFTY15MAR1824500PE_2018-03-14.csv,10,4,6,-22.5,24880.5
BANKNIFTY15MAR1824600CE_2018-03-14.csv,8,4,4,758.25,38042.25
BANKNIFTY15MAR1824600PE_2018-03-14.csv,9,5,4,260.25,34985.25
BANKNIFTY15MAR1824700CE_2018-03-14.csv,9,5,4,651.0,32115.0
BANKNIFTY15MAR1824700PE_2018-03-14.csv,12,6,6,593.25,63564.75
BANKNIFTY15MAR1824800CE_2018-03-14.csv,10,4,6,5.25,22709.25
BANKNIFTY15MAR1824800PE_2018-03-14.csv,10,5,5,702.0,71839.5
BANKNIFTY15MAR1824900CE_2018-03-14.csv,12,6,6,42.0,17773.5
BANKNIFTY15MAR1824900PE_2018-03-14.csv,20,7,13,-447.0,182629.5
BANKNIFTY15MAR1825000CE_2018-03-14.csv,11,5,6,34.5,9774.0
BANKNIFTY15MAR1825100CE_2018-03-14.csv,15,9,6,96.75,6846.75
BANKNIFTY15MAR1824500CE_2018-03-15.csv,14,7,7,1456.5,142224.0
BANKNIFTY15MAR1824600CE_2018-03-15.csv,13,4,9,-968.25,95459.25
BANKNIFTY15MAR1824700CE_2018-03-15.csv,12,5,7,61.5,62470.5
BANKNIFTY15MAR1824700PE_2018-03-15.csv,16,7,9,-129.75,9174.0
BANKNIFTY15MAR1824800CE_2018-03-15.csv,11,5,6,197.25,28785.0
BANKNIFTY15MAR1824800PE_2018-03-15.csv,10,6,4,153.0,14188.5
BANKNIFTY15MAR1824900CE_2018-03-15.csv,12,4,8,-96.0,15102.75
BANKNIFTY15MAR1824900PE_2018-03-15.csv,10,4,6,-414.75,27296.25
BANKNIFTY15MAR1825000CE_2018-03-15.csv,11,3,8,-59.25,6118.5
BANKNIFTY15MAR1825000PE_2018-03-15.csv,10,5,5,-11.25,51159.75
BANKNIFTY15MAR1825100PE_2018-03-15.csv,15,10,5,2486.25,104354.25
BANKNIFTY15MAR1825200PE_2018-03-15.csv,19,10,9,2945.25,186576.75
BANKNIFTY22MAR1823800PE_2018-03-16.csv,12,6,6,116.25,10745.25
BANKNIFTY22MAR1823900PE_2018-03-16.csv,14,6,8,81.75,15344.25
BANKNIFTY22MAR1824000PE_2018-03-16.csv,11,3,8,-149.25,16556.25
BANKNIFTY22MAR1824100PE_2018-03-16.csv,8,3,5,120.0,16191.0
BANKNIFTY22MAR1824200PE_2018-03-16.csv,9,5,4,329.25,18695.25
BANKNIFTY22MAR1824300PE_2018-03-16.csv,10,5,5,259.5,30063.0
BANKNIFTY22MAR1824400PE_2018-03-16.csv,9,4,5,169.5,35506.5
BANKNIFTY22MAR1824500PE_2018-03-16.csv,6,3,3,525.75,28622.25
BANKNIFTY22MAR1824600CE_2018-03-16.csv,7,4,3,986.25,63438.75
BANKNIFTY22MAR1824600PE_2018-03-16.csv,8,4,4,535.5,48865.5
BANKNIFTY22MAR1824700CE_2018-03-16.csv,6,3,3,-122.25,42398.25
BANKNIFTY22MAR1824700PE_2018-03-16.csv,8,4,4,580.5,59859.0
BANKNIFTY22MAR1824800CE_2018-03-16.csv,5,2,3,-98.25,29456.25
BANKNIFTY22MAR1824800PE_2018-03-16.csv,7,3,4,504.75,63486.75
BANKNIFTY22MAR1824900CE_2018-03-16.csv,8,3,5,-395.25,38013.0
BANKNIFTY22MAR1824900PE_2018-03-16.csv,10,4,6,564.0,97632.0
BANKNIFTY22MAR1825000CE_2018-03-16.csv,7,3,4,-246.75,26454.75
BANKNIFTY22MAR1825100CE_2018-03-16.csv,5,1,4,-321.75,14729.25
BANKNIFTY22MAR1825200CE_2018-03-16.csv,6,3,3,180.0,12190.5
BANKNIFTY22MAR1825300CE_2018-03-16.csv,7,2,5,-75.0,9678.0
BANKNIFTY22MAR1825400CE_2018-03-16.csv,9,4,5,-5.25,9321.0
BANKNIFTY22MAR1825500CE_2018-03-16.csv,10,3,7,-77.25,6432.75
BANKNIFTY22MAR1823600PE_2018-03-19.csv,11,4,7,-63.0,11554.5
BANKNIFTY22MAR1823700PE_2018-03-19.csv,15,7,8,-27.0,19414.5
BANKNIFTY22MAR1823800PE_2018-03-19.csv,13,4,9,-218.25,22824.0
BANKNIFTY22MAR1823900PE_2018-03-19.csv,11,3,8,-252.0,23733.0
BANKNIFTY22MAR1824000PE_2018-03-19.csv,10,4,6,50.25,29523.75
BANKNIFTY22MAR1824100PE_2018-03-19.csv,12,5,7,71.25,44813.25
BANKNIFTY22MAR1824200PE_2018-03-19.csv,12,5,7,95.25,54376.5
BANKNIFTY22MAR1824300CE_2018-03-19.csv,13,2,11,-2409.0,103950.0
BANKNIFTY22MAR1824300PE_2018-03-19.csv,12,4,8,-144.75,67347.75
BANKNIFTY22MAR1824400CE_2018-03-19.csv,10,2,8,-1198.5,64642.5
BANKNIFTY22MAR1824400PE_2018-03-19.csv,10,3,7,-648.0,70741.5
BANKNIFTY22MAR1824500CE_2018-03-19.csv,9,4,5,-408.0,47951.25
BANKNIFTY22MAR1824500PE_2018-03-19.csv,7,3,4,168.0,64233.0
BANKNIFTY22MAR1824600CE_2018-03-19.csv,12,4,8,-789.0,45568.5
BANKNIFTY22MAR1824600PE_2018-03-19.csv,9,3,6,-603.0,90102.0
BANKNIFTY22MAR1824700CE_2018-03-19.csv,13,5,8,-384.0,38241.75
BANKNIFTY22MAR1824700PE_2018-03-19.csv,7,3,4,69.75,90168.75
BANKNIFTY22MAR1824800CE_2018-03-19.csv,12,3,9,-583.5,22501.5
BANKNIFTY22MAR1824900CE_2018-03-19.csv,14,4,10,-344.25,19332.75
BANKNIFTY22MAR1825000CE_2018-03-19.csv,7,0,7,-324.75,7430.25
BANKNIFTY22MAR1825100CE_2018-03-19.csv,13,4,9,-198.0,9563.25
BANKNIFTY22MAR1825200CE_2018-03-19.csv,12,3,9,-153.75,6141.75
BANKNIFTY22MAR1823500PE_2018-03-20.csv,16,8,8,141.75,8781.75
BANKNIFTY22MAR1823600PE_2018-03-20.csv,18,8,10,88.5,13257.0
BANKNIFTY22MAR1823700PE_2018-03-20.csv,14,6,8,101.25,15225.75
BANKNIFTY22MAR1823800PE_2018-03-20.csv,14,6,8,-15.75,20208.75
BANKNIFTY22MAR1823900PE_2018-03-20.csv,16,8,8,309.0,32236.5
BANKNIFTY22MAR1824000PE_2018-03-20.csv,11,7,4,637.5,29358.0
BANKNIFTY22MAR1824100CE_2018-03-20.csv,8,3,5,45.0,68025.0
BANKNIFTY22MAR1824100PE_2018-03-20.csv,13,7,6,701.25,48339.0
BANKNIFTY22MAR1824200CE_2018-03-20.csv,8,3,5,-217.5,49590.0
BANKNIFTY22MAR1824200PE_2018-03-20.csv,9,5,4,730.5,44256.0
BANKNIFTY22MAR1824300CE_2018-03-20.csv,8,3,5,-195.0,37261.5
BANKNIFTY22MAR1824300PE_2018-03-20.csv,9,3,6,-558.75,55845.75
BANKNIFTY22MAR1824400CE_2018-03-20.csv,10,4,6,-245.25,30894.75
BANKNIFTY22MAR1824400PE_2018-03-20.csv,9,2,7,-845.25,67067.25
BANKNIFTY22MAR1824500CE_2018-03-20.csv,7,3,4,72.0,18285.0
BANKNIFTY22MAR1824500PE_2018-03-20.csv,10,4,6,-92.25,96533.25
BANKNIFTY22MAR1824600CE_2018-03-20.csv,10,3,7,-251.25,15983.25
BANKNIFTY22MAR1824700CE_2018-03-20.csv,13,7,6,236.25,14363.25
BANKNIFTY22MAR1824800CE_2018-03-20.csv,10,5,5,159.75,7086.0
BANKNIFTY22MAR1823900PE_2018-03-21.csv,7,4,3,75.0,3397.5
BANKNIFTY22MAR1824000PE_2018-03-21.csv,9,3,6,-27.0,7258.5
BANKNIFTY22MAR1824100CE_2018-03-21.csv,11,2,9,-1751.25,91451.25
BANKNIFTY22MAR1824100PE_2018-03-21.csv,9,5,4,221.25,11946.75
BANKNIFTY22MAR1824200CE_2018-03-21.csv,8,1,7,-1092.75,54912.75
BANKNIFTY22MAR1824200PE_2018-03-21.csv,9,2,7,-205.5,16867.5
BANKNIFTY22MAR1824300CE_2018-03-21.csv,7,3,4,-147.75,31995.75
BANKNIFTY22MAR1824300PE_2018-03-21.csv,7,2,5,-27.0,21791.25
BANKNIFTY22MAR1824400CE_2018-03-21.csv,8,1,7,-559.5,27136.5
BANKNIFTY22MAR1824400PE_2018-03-21.csv,9,4,5,486.0,41084.25
BANKNIFTY22MAR1824500CE_2018-03-21.csv,8,1,7,-483.0,16920.0
BANKNIFTY22MAR1824500PE_2018-03-21.csv,10,5,5,1136.25,56900.25
BANKNIFTY22MAR1824600CE_2018-03-21.csv,9,2,7,-269.25,11150.25
BANKNIFTY22MAR1824600PE_2018-03-21.csv,13,6,7,1089.0,107017.5
BANKNIFTY22MAR1824700CE_2018-03-21.csv,8,4,4,71.25,5526.75
BANKNIFTY22MAR1824700PE_2018-03-21.csv,11,5,6,1323.75,119462.25
BANKNIFTY22MAR1824000CE_2018-03-22.csv,12,2,10,-1392.0,80173.5
BANKNIFTY22MAR1824100CE_2018-03-22.csv,7,1,6,-572.25,34767.75
BANKNIFTY22MAR1824100PE_2018-03-22.csv,13,5,8,-208.5,3723.75
BANKNIFTY22MAR1824200CE_2018-03-22.csv,11,3,8,-372.75,14620.5
BANKNIFTY22MAR1824200PE_2018-03-22.csv,7,1,6,-313.5,8980.5
BANKNIFTY22MAR1824300CE_2018-03-22.csv,9,4,5,-177.0,8478.75
BANKNIFTY22MAR1824300PE_2018-03-22.csv,12,4,8,-435.75,34310.25
BANKNIFTY22MAR1824400CE_2018-03-22.csv,17,7,10,-66.75,4759.5
BANKNIFTY22MAR1824400PE_2018-03-22.csv,10,3,7,-585.0,48520.5
BANKNIFTY22MAR1824500PE_2018-03-22.csv,6,2,4,-84.75,50243.25
BANKNIFTY22MAR1824600PE_2018-03-22.csv,13,6,7,476.25,136662.75
BANKNIFTY28MAR1822900PE_2018-03-23.csv,16,9,7,211.5,13738.5
BANKNIFTY28MAR1823000PE_2018-03-23.csv,13,7,6,156.0,14308.5
BANKNIFTY28MAR1823100PE_2018-03-23.csv,14,5,9,-168.0,19546.5
BANKNIFTY28MAR1823200PE_2018-03-23.csv,13,6,7,206.25,22914.75
BANKNIFTY28MAR1823300PE_2018-03-23.csv,10,4,6,21.75,23046.75
BANKNIFTY28MAR1823400PE_2018-03-23.csv,12,7,5,600.75,37289.25
BANKNIFTY28MAR1823500CE_2018-03-23.csv,8,3,5,11.25,81128.25
BANKNIFTY28MAR1823500PE_2018-03-23.csv,11,6,5,569.25,41564.25
BANKNIFTY28MAR1823600CE_2018-03-23.csv,11,3,8,-903.75,91770.75
BANKNIFTY28MAR1823600PE_2018-03-23.csv,9,4,5,390.75,43464.75
BANKNIFTY28MAR1823700CE_2018-03-23.csv,9,2,7,-996.0,57258.0
BANKNIFTY28MAR1823700PE_2018-03-23.csv,9,3,6,-338.25,53657.25
BANKNIFTY28MAR1823800CE_2018-03-23.csv,10,2,8,-543.0,45015.0
BANKNIFTY28MAR1823800PE_2018-03-23.csv,10,3,7,-553.5,73654.5
BANKNIFTY28MAR1823900CE_2018-03-23.csv,11,2,9,-562.5,35530.5
BANKNIFTY28MAR1823900PE_2018-03-23.csv,8,3,5,-20.25,74916.75
BANKNIFTY28MAR1824000CE_2018-03-23.csv,13,3,10,-279.0,30864.0
BANKNIFTY28MAR1824100CE_2018-03-23.csv,10,2,8,-300.0,17538.0
BANKNIFTY28MAR1824100PE_2018-03-23.csv,7,3,4,143.25,98201.25
BANKNIFTY28MAR1824200CE_2018-03-23.csv,12,1,11,-423.0,15507.0
BANKNIFTY28MAR1824300CE_2018-03-23.csv,15,6,9,20.25,12414.75
BANKNIFTY28MAR1824400CE_2018-03-23.csv,12,2,10,-137.25,7118.25
BANKNIFTY28MAR1823000PE_2018-03-26.csv,11,2,9,-50.25,2873.25
BANKNIFTY28MAR1823100PE_2018-03-26.csv,15,4,11,-63.75,5091.75
BANKNIFTY28MAR1823200PE_2018-03-26.csv,13,3,10,-72.75,6596.25
BANKNIFTY28MAR1823300PE_2018-03-26.csv,15,2,13,-231.75,10856.25
BANKNIFTY28MAR1823400PE_2018-03-26.csv,14,2,12,-803.25,15806.25
BANKNIFTY28MAR1823500CE_2018-03-26.csv,8,7,1,4808.25,124809.75
BANKNIFTY28MAR1823500PE_2018-03-26.csv,11,1,10,-296.25,13923.75
BANKNIFTY28MAR1823600CE_2018-03-26.csv,9,6,3,3082.5,94087.5
BANKNIFTY28MAR1823600PE_2018-03-26.csv,13,3,10,-446.25,23072.25
BANKNIFTY28MAR1823700CE_2018-03-26.csv,8,7,1,3029.25,75572.25
BANKNIFTY28MAR1823700PE_2018-03-26.csv,9,1,8,-390.75,20750.25
BANKNIFTY28MAR1823800CE_2018-03-26.csv,10,8,2,3005.25,81194.25
BANKNIFTY28MAR1823800PE_2018-03-26.csv,8,1,7,-649.5,29176.5
BANKNIFTY28MAR1823900CE_2018-03-26.csv,8,7,1,1949.25,52283.25
BANKNIFTY28MAR1823900PE_2018-03-26.csv,12,2,10,-797.25,53954.25
BANKNIFTY28MAR1824000CE_2018-03-26.csv,6,5,1,682.5,26251.5
BANKNIFTY28MAR1824000PE_2018-03-26.csv,10,0,10,-1977.0,56116.5
BANKNIFTY28MAR1824100CE_2018-03-26.csv,6,4,2,264.0,16699.5
BANKNIFTY28MAR1824200CE_2018-03-26.csv,7,5,2,304.5,10560.0
BANKNIFTY28MAR1824000PE_2018-03-27.csv,12,6,6,78.0,7588.5
BANKNIFTY28MAR1824100CE_2018-03-27.csv,15,4,11,-2106.0,149778.0
BANKNIFTY28MAR1824100PE_2018-03-27.csv,8,5,3,147.0,8383.5
BANKNIFTY28MAR1824200CE_2018-03-27.csv,15,4,11,-1260.0,116006.25
BANKNIFTY28MAR1824200PE_2018-03-27.csv,12,7,5,300.75,16125.75
BANKNIFTY28MAR1824300CE_2018-03-27.csv,11,3,8,-909.0,62672.25
BANKNIFTY28MAR1824300PE_2018-03-27.csv,13,9,4,786.0,29860.5
BANKNIFTY28MAR1824400CE_2018-03-27.csv,13,3,10,-1173.75,52833.75
BANKNIFTY28MAR1824400PE_2018-03-27.csv,9,4,5,45.75,31856.25
BANKNIFTY28MAR1824500CE_2018-03-27.csv,15,6,9,-299.25,38339.25
BANKNIFTY28MAR1824500PE_2018-03-27.csv,12,6,6,720.0,66447.0
BANKNIFTY28MAR1824600CE_2018-03-27.csv,14,5,9,-269.25,22710.75
BANKNIFTY28MAR1824600PE_2018-03-27.csv,16,6,10,243.0,116997.75
BANKNIFTY28MAR1824700CE_2018-03-27.csv,17,8,9,112.5,16228.5
BANKNIFTY28MAR1824800CE_2018-03-27.csv,19,7,12,-192.75,9992.25
BANKNIFTY28MAR1824000CE_2018-03-28.csv,13,4,9,-684.0,113262.0
BANKNIFTY28MAR1824100CE_2018-03-28.csv,12,5,7,228.75,69787.5
BANKNIFTY28MAR1824100PE_2018-03-28.csv,17,8,9,-39.0,5025.75
BANKNIFTY28MAR1824200CE_2018-03-28.csv,10,4,6,-99.75,30548.25
BANKNIFTY28MAR1824200PE_2018-03-28.csv,13,3,10,-210.0,10637.25
BANKNIFTY28MAR1824300CE_2018-03-28.csv,14,5,9,-246.0,11457.75
BANKNIFTY28MAR1824300PE_2018-03-28.csv,12,4,8,-219.75,24849.75
BANKNIFTY28MAR1824400CE_2018-03-28.csv,7,2,5,-146.25,3933.0
BANKNIFTY28MAR1824400PE_2018-03-28.csv,9,2,7,-679.5,34719.0
BANKNIFTY28MAR1824500CE_2018-03-28.csv,16,8,8,-18.75,2442.0
BANKNIFTY28MAR1824500PE_2018-03-28.csv,13,5,8,-718.5,80923.5
BANKNIFTY28MAR1824600PE_2018-03-28.csv,12,4,8,-1219.5,114101.25
BANKNIFTY05APR1823400PE_2018-04-02.csv,13,4,9,-36.75,7800.75
BANKNIFTY05APR1823500PE_2018-04-02.csv,13,3,10,-67.5,10759.5
BANKNIFTY05APR1823600PE_2018-04-02.csv,11,2,9,-168.0,13254.0
BANKNIFTY05APR1823700PE_2018-04-02.csv,10,4,6,28.5,14562.0
BANKNIFTY05APR1823800PE_2018-04-02.csv,9,2,7,-250.5,17784.0
BANKNIFTY05APR1823900PE_2018-04-02.csv,10,3,7,-186.75,27156.75
BANKNIFTY05APR1824000CE_2018-04-02.csv,8,4,4,931.5,89591.25
BANKNIFTY05APR1824000PE_2018-04-02.csv,11,3,8,-401.25,37329.75
BANKNIFTY05APR1824100CE_2018-04-02.csv,8,3,5,-375.0,72908.25
BANKNIFTY05APR1824100PE_2018-04-02.csv,10,2,8,-877.5,45339.75
BANKNIFTY05APR1824200CE_2018-04-02.csv,9,3,6,-456.0,63566.25
BANKNIFTY05APR1824200PE_2018-04-02.csv,9,3,6,-141.75,53433.75
BANKNIFTY05APR1824300CE_2018-04-02.csv,7,1,6,-995.25,39842.25
BANKNIFTY05APR1824300PE_2018-04-02.csv,11,5,6,595.5,76818.0
BANKNIFTY05APR1824400CE_2018-04-02.csv,8,3,5,-181.5,34009.5
BANKNIFTY05APR1824400PE_2018-04-02.csv,11,3,8,-931.5,92452.5
BANKNIFTY05APR1824500CE_2018-04-02.csv,9,2,7,-446.25,26868.75
BANKNIFTY05APR1824600CE_2018-04-02.csv,9,3,6,-117.75,17025.75
BANKNIFTY05APR1824700CE_2018-04-02.csv,10,4,6,23.25,14544.75
BANKNIFTY05APR1824800CE_2018-04-02.csv,15,5,10,-75.75,13500.75
BANKNIFTY05APR1824900CE_2018-04-02.csv,15,5,10,-50.25,8575.5
BANKNIFTY05APR1823700PE_2018-04-03.csv,19,5,14,-57.75,7833.75
BANKNIFTY05APR1823800PE_2018-04-03.csv,12,2,10,-153.0,7186.5
BANKNIFTY05APR1823900PE_2018-04-03.csv,12,3,9,-78.75,10062.75
BANKNIFTY05APR1824000PE_2018-04-03.csv,10,2,8,-189.75,13766.25
BANKNIFTY05APR1824100PE_2018-04-03.csv,10,1,9,-454.5,17923.5
BANKNIFTY05APR1824200CE_2018-04-03.csv,10,5,5,1138.5,93786.0
BANKNIFTY05APR1824200PE_2018-04-03.csv,6,2,4,-83.25,15722.25
BANKNIFTY05APR1824300CE_2018-04-03.csv,7,4,3,981.75,52358.25
BANKNIFTY05APR1824300PE_2018-04-03.csv,11,3,8,-389.25,39189.75
BANKNIFTY05APR1824400CE_2018-04-03.csv,7,3,4,276.0,41522.25
BANKNIFTY05APR1824400PE_2018-04-03.csv,12,4,8,-474.0,55731.0
BANKNIFTY05APR1824500CE_2018-04-03.csv,5,1,4,-249.75,18573.75
BANKNIFTY05APR1824500PE_2018-04-03.csv,13,4,9,-464.25,77223.75
BANKNIFTY05APR1824600CE_2018-04-03.csv,5,0,5,-348.75,14239.5
BANKNIFTY05APR1824600PE_2018-04-03.csv,12,3,9,-946.5,90102.0
BANKNIFTY05APR1824700CE_2018-04-03.csv,6,2,4,7.5,11472.0
BANKNIFTY05APR1824800CE_2018-04-03.csv,10,4,6,71.25,10533.75
BANKNIFTY05APR1824200PE_2018-04-04.csv,10,5,5,9.0,22659.0
BANKNIFTY05APR1824300CE_2018-04-04.csv,10,2,8,-1064.25,69366.75
BANKNIFTY05APR1824300PE_2018-04-04.csv,10,7,3,837.0,22296.0
BANKNIFTY05APR1824400CE_2018-04-04.csv,10,1,9,-1468.5,36387.0
BANKNIFTY05APR1824400PE_2018-04-04.csv,10,6,4,537.0,45826.5
BANKNIFTY05APR1824500CE_2018-04-04.csv,11,3,8,-741.0,32101.5
BANKNIFTY05APR1824500PE_2018-04-04.csv,9,4,5,-156.0,54564.0
BANKNIFTY05APR1824600CE_2018-04-04.csv,10,4,6,-348.75,17319.0
BANKNIFTY05APR1824600PE_2018-04-04.csv,7,4,3,702.75,53871.75
BANKNIFTY05APR1824700CE_2018-04-04.csv,12,3,9,-323.25,11351.25
BANKNIFTY05APR1824700PE_2018-04-04.csv,12,7,5,2407.5,117667.5
BANKNIFTY05APR1824800CE_2018-04-04.csv,18,4,14,-183.75,9578.25
BANKNIFTY05APR1824800PE_2018-04-04.csv,12,8,4,4103.25,137286.75
BANKNIFTY05APR1824900CE_2018-04-04.csv,18,4,14,-84.0,4707.0
BANKNIFTY05APR1824100CE_2018-04-05.csv,9,4,5,820.5,105849.0
BANKNIFTY05APR1824100PE_2018-04-05.csv,25,11,14,-27.0,1698.75
BANKNIFTY05APR1824200CE_2018-04-05.csv,9,3,6,-330.75,69275.25
BANKNIFTY05APR1824200PE_2018-04-05.csv,19,11,8,23.25,2241.0
BANKNIFTY05APR1824300CE_2018-04-05.csv,10,5,5,917.25,66602.25
BANKNIFTY05APR1824300PE_2018-04-05.csv,19,12,7,51.75,5697.0
BANKNIFTY05APR1824400CE_2018-04-05.csv,11,6,5,344.25,34029.75
BANKNIFTY05APR1824400PE_2018-04-05.csv,21,12,9,84.75,13429.5
BANKNIFTY05APR1824500CE_2018-04-05.csv,11,4,7,-85.5,17584.5
BANKNIFTY05APR1824500PE_2018-04-05.csv,13,7,6,-366.75,16105.5
BANKNIFTY05APR1824600CE_2018-04-05.csv,13,7,6,98.25,7841.25
BANKNIFTY05APR1824600PE_2018-04-05.csv,11,6,5,431.25,35749.5
BANKNIFTY05APR1824700PE_2018-04-05.csv,12,4,8,-1280.25,64152.0
BANKNIFTY12APR1823800PE_2018-04-06.csv,13,3,10,-156.75,9410.25
BANKNIFTY12APR1823900PE_2018-04-06.csv,16,5,11,-93.75,15035.25
BANKNIFTY12APR1824000PE_2018-04-06.csv,10,3,7,-69.0,11713.5
BANKNIFTY12APR1824100PE_2018-04-06.csv,14,2,12,-482.25,19940.25
BANKNIFTY12APR1824200PE_2018-04-06.csv,10,1,9,-438.0,17017.5
BANKNIFTY12APR1824300PE_2018-04-06.csv,11,3,8,-251.25,24936.75
BANKNIFTY12APR1824400PE_2018-04-06.csv,10,2,8,-467.25,28179.75
BANKNIFTY12APR1824500CE_2018-04-06.csv,9,4,5,608.25,103824.75
BANKNIFTY12APR1824500PE_2018-04-06.csv,10,2,8,-645.75,35238.75
BANKNIFTY12APR1824600CE_2018-04-06.csv,10,4,6,243.0,96279.0
BANKNIFTY12APR1824600PE_2018-04-06.csv,10,3,7,-406.5,42870.0
BANKNIFTY12APR1824700CE_2018-04-06.csv,12,4,8,-214.5,87828.75
BANKNIFTY12APR1824700PE_2018-04-06.csv,12,3,9,-777.0,64692.0
BANKNIFTY12APR1824800CE_2018-04-06.csv,11,5,6,364.5,64695.75
BANKNIFTY12APR1824800PE_2018-04-06.csv,11,3,8,-764.25,74858.25
BANKNIFTY12APR1824900CE_2018-04-06.csv,10,5,5,227.25,43838.25
BANKNIFTY12APR1824900PE_2018-04-06.csv,13,3,10,-1679.25,107142.75
BANKNIFTY12APR1825000CE_2018-04-06.csv,11,5,6,29.25,35242.5
BANKNIFTY12APR1825000PE_2018-04-06.csv,12,3,9,-1294.5,121701.0
BANKNIFTY12APR1825100CE_2018-04-06.csv,12,4,8,-201.0,27180.0
BANKNIFTY12APR1825200CE_2018-04-06.csv,13,7,6,183.75,19521.75
BANKNIFTY12APR1825300CE_2018-04-06.csv,13,8,5,285.75,13238.25
BANKNIFTY12APR1824100PE_2018-04-09.csv,10,2,8,-78.75,5937.75
BANKNIFTY12APR1824200PE_2018-04-09.csv,11,4,7,-6.75,7869.0
BANKNIFTY12APR1824300PE_2018-04-09.csv,12,3,9,-99.0,10919.25
BANKNIFTY12APR1824400PE_2018-04-09.csv,10,4,6,-0.75,11240.25
BANKNIFTY12APR1824500PE_2018-04-09.csv,11,1,10,-357.0,15066.0
BANKNIFTY12APR1824600PE_2018-04-09.csv,9,2,7,-181.5,16166.25
BANKNIFTY12APR1824700CE_2018-04-09.csv,7,4,3,1368.75,84936.75
BANKNIFTY12APR1824700PE_2018-04-09.csv,10,2,8,-373.5,21294.0
BANKNIFTY12APR1824800CE_2018-04-09.csv,7,5,2,1902.75,74098.5
BANKNIFTY12APR1824800PE_2018-04-09.csv,10,2,8,-493.5,29326.5
BANKNIFTY12APR1824900CE_2018-04-09.csv,8,4,4,540.75,65619.75
BANKNIFTY12APR1824900PE_2018-04-09.csv,7,1,6,-436.5,28079.25
BANKNIFTY12APR1825000CE_2018-04-09.csv,8,6,2,1152.75,50307.0
BANKNIFTY12APR1825000PE_2018-04-09.csv,9,2,7,-558.0,42556.5
BANKNIFTY12APR1825100CE_2018-04-09.csv,8,6,2,1102.5,37601.25
BANKNIFTY12APR1825100PE_2018-04-09.csv,10,2,8,-1101.75,60969.75
BANKNIFTY12APR1825200CE_2018-04-09.csv,6,3,3,147.75,20136.75
BANKNIFTY12APR1825200PE_2018-04-09.csv,14,3,11,-1619.25,111719.25
BANKNIFTY12APR1825300CE_2018-04-09.csv,8,4,4,96.75,18264.75
BANKNIFTY12APR1825400CE_2018-04-09.csv,10,5,5,118.5,15885.0
BANKNIFTY12APR1825500CE_2018-04-09.csv,10,5,5,102.75,11214.0
BANKNIFTY12APR1824500PE_2018-04-10.csv,13,3,10,-105.75,7311.75
BANKNIFTY12APR1824600PE_2018-04-10.csv,10,1,9,-165.0,7243.5
BANKNIFTY12APR1824700PE_2018-04-10.csv,11,2,9,-141.75,10781.25
BANKNIFTY12APR1824800PE_2018-04-10.csv,9,1,8,-272.25,12287.25
BANKNIFTY12APR1824900CE_2018-04-10.csv,9,4,5,717.75,88827.75
BANKNIFTY12APR1824900PE_2018-04-10.csv,10,2,8,-283.5,19096.5
BANKNIFTY12APR1825000CE_2018-04-10.csv,6,3,3,441.75,46682.25
BANKNIFTY12APR1825000PE_2018-04-10.csv,8,0,8,-620.25,21080.25
BANKNIFTY12APR1825100CE_2018-04-10.csv,9,3,6,-301.5,50667.75
BANKNIFTY12APR1825100PE_2018-04-10.csv,8,2,6,-409.5,31021.5
BANKNIFTY12APR1825200CE_2018-04-10.csv,10,4,6,28.5,40300.5
BANKNIFTY12APR1825200PE_2018-04-10.csv,8,2,6,-446.25,41556.75
BANKNIFTY12APR1825300CE_2018-04-10.csv,7,3,4,160.5,19712.25
BANKNIFTY12APR1825300PE_2018-04-10.csv,9,2,7,-703.5,61573.5
BANKNIFTY12APR1825400CE_2018-04-10.csv,11,4,7,1.5,20044.5
BANKNIFTY12APR1825400PE_2018-04-10.csv,12,2,10,-1842.0,103030.5
BANKNIFTY12APR1825500CE_2018-04-10.csv,10,3,7,-103.5,11588.25
BANKNIFTY12APR1824600PE_2018-04-11.csv,12,4,8,-4.5,6401.25
BANKNIFTY12APR1824700PE_2018-04-11.csv,8,1,7,-253.5,6553.5
BANKNIFTY12APR1824800CE_2018-04-11.csv,15,6,9,444.0,118746.0
BANKNIFTY12APR1824800PE_2018-04-11.csv,11,4,7,-30.0,14272.5
BANKNIFTY12APR1824900CE_2018-04-11.csv,13,6,7,618.0,74187.0
BANKNIFTY12APR1824900PE_2018-04-11.csv,9,4,5,-1.5,17550.0
BANKNIFTY12APR1825000CE_2018-04-11.csv,7,4,3,322.5,24768.0
BANKNIFTY12APR1825000PE_2018-04-11.csv,10,4,6,-30.75,30350.25
BANKNIFTY12APR1825100CE_2018-04-11.csv,5,2,3,-99.75,12845.25
BANKNIFTY12APR1825100PE_2018-04-11.csv,8,2,6,-593.25,35921.25
BANKNIFTY12APR1825200CE_2018-04-11.csv,9,2,7,-351.75,13970.25
BANKNIFTY12APR1825200PE_2018-04-11.csv,10,3,7,-244.5,68861.25
BANKNIFTY12APR1825300CE_2018-04-11.csv,12,3,9,-195.0,9913.5
BANKNIFTY12APR1825300PE_2018-04-11.csv,11,3,8,-882.0,97182.0
BANKNIFTY12APR1825400CE_2018-04-11.csv,9,3,6,-103.5,4366.5
BANKNIFTY12APR1824700CE_2018-04-12.csv,12,8,4,4088.25,137976.75
BANKNIFTY12APR1824800CE_2018-04-12.csv,14,10,4,3924.75,126327.75
BANKNIFTY12APR1824900CE_2018-04-12.csv,10,6,4,1499.25,66756.75
BANKNIFTY12APR1824900PE_2018-04-12.csv,27,13,14,-46.5,6005.25
BANKNIFTY12APR1825000CE_2018-04-12.csv,12,8,4,1675.5,47367.0
BANKNIFTY12APR1825000PE_2018-04-12.csv,21,9,12,-141.75,9829.5
BANKNIFTY12APR1825100CE_2018-04-12.csv,23,15,8,1132.5,34485.0
BANKNIFTY12APR1825100PE_2018-04-12.csv,18,5,13,-1000.5,24740.25
BANKNIFTY12APR1825200CE_2018-04-12.csv,23,14,9,136.5,7835.25
BANKNIFTY12APR1825200PE_2018-04-12.csv,13,5,8,-261.0,44842.5
BANKNIFTY12APR1825300PE_2018-04-12.csv,17,2,15,-2784.0,102976.5
BANKNIFTY19APR1824500PE_2018-04-13.csv,14,4,10,-102.0,9756.0
BANKNIFTY19APR1824600PE_2018-04-13.csv,13,4,9,-39.75,11840.25
BANKNIFTY19APR1824700PE_2018-04-13.csv,11,4,7,-15.75,14021.25
BANKNIFTY19APR1824800PE_2018-04-13.csv,10,3,7,-104.25,17289.75
BANKNIFTY19APR1824900PE_2018-04-13.csv,12,2,10,-618.0,28563.0
BANKNIFTY19APR1825000CE_2018-04-13.csv,5,2,3,-277.5,47694.0
BANKNIFTY19APR1825000PE_2018-04-13.csv,10,2,8,-480.0,29343.0
BANKNIFTY19APR1825100CE_2018-04-13.csv,9,2,7,-981.75,68840.25
BANKNIFTY19APR1825100PE_2018-04-13.csv,13,4,9,-474.75,51951.75
BANKNIFTY19APR1825200CE_2018-04-13.csv,5,2,3,-33.75,32883.75
BANKNIFTY19APR1825200PE_2018-04-13.csv,11,3,8,-819.0,58252.5
BANKNIFTY19APR1825300CE_2018-04-13.csv,6,2,4,-474.75,28962.75
BANKNIFTY19APR1825300PE_2018-04-13.csv,8,0,8,-1809.0,57991.5
BANKNIFTY19APR1825400CE_2018-04-13.csv,7,2,5,-213.75,27185.25
BANKNIFTY19APR1825400PE_2018-04-13.csv,10,2,8,-1338.0,86844.0
BANKNIFTY19APR1825500CE_2018-04-13.csv,8,4,4,94.5,23548.5
BANKNIFTY19APR1825500PE_2018-04-13.csv,11,4,7,-315.75,112829.25
BANKNIFTY19APR1825600CE_2018-04-13.csv,7,3,4,4.5,14872.5
BANKNIFTY19APR1825700CE_2018-04-13.csv,10,4,6,-84.75,13449.0
BANKNIFTY19APR1825800CE_2018-04-13.csv,8,3,5,-1.5,7267.5
BANKNIFTY19APR1825900CE_2018-04-13.csv,8,4,4,51.75,5193.75
BANKNIFTY19APR1824300PE_2018-04-16.csv,16,8,8,39.75,5397.75
BANKNIFTY19APR1824400PE_2018-04-16.csv,15,5,10,-41.25,6759.75
BANKNIFTY19APR1824500PE_2018-04-16.csv,13,4,9,-78.75,7328.25
BANKNIFTY19APR1824600PE_2018-04-16.csv,12,4,8,-30.0,9711.0
BANKNIFTY19APR1824700PE_2018-04-16.csv,12,4,8,-76.5,13431.0
BANKNIFTY19APR1824800PE_2018-04-16.csv,13,3,10,-352.5,19450.5
BANKNIFTY19APR1824900PE_2018-04-16.csv,9,2,7,-339.75,17724.75
BANKNIFTY19APR1825000CE_2018-04-16.csv,8,3,5,66.75,72306.75
BANKNIFTY19APR1825000PE_2018-04-16.csv,12,4,8,-77.25,36305.25
BANKNIFTY19APR1825100CE_2018-04-16.csv,7,3,4,219.75,52689.75
BANKNIFTY19APR1825100PE_2018-04-16.csv,9,3,6,-180.0,36852.0
BANKNIFTY19APR1825200CE_2018-04-16.csv,10,5,5,820.5,53584.5
BANKNIFTY19APR1825200PE_2018-04-16.csv,6,2,4,-178.5,35088.0
BANKNIFTY19APR1825300CE_2018-04-16.csv,9,5,4,611.25,36527.25
BANKNIFTY19APR1825300PE_2018-04-16.csv,9,2,7,-879.75,57546.75
BANKNIFTY19APR1825400CE_2018-04-16.csv,7,4,3,371.25,20168.25
BANKNIFTY19APR1825400PE_2018-04-16.csv,13,3,10,-1452.75,109128.75
BANKNIFTY19APR1825500CE_2018-04-16.csv,10,4,6,17.25,21498.0
BANKNIFTY19APR1825600CE_2018-04-16.csv,14,6,8,68.25,19633.5
BANKNIFTY19APR1825700CE_2018-04-16.csv,11,5,6,84.0,9123.0
BANKNIFTY19APR1824900PE_2018-04-17.csv,8,3,5,32.25,6600.75
BANKNIFTY19APR1825000CE_2018-04-17.csv,11,5,6,645.75,115101.75
BANKNIFTY19APR1825000PE_2018-04-17.csv,7,2,5,0.0,9845.25
BANKNIFTY19APR1825100CE_2018-04-17.csv,9,4,5,17.25,74109.75
BANKNIFTY19APR1825100PE_2018-04-17.csv,6,3,3,217.5,12130.5
BANKNIFTY19APR1825200CE_2018-04-17.csv,10,4,6,-26.25,61193.25
BANKNIFTY19APR1825200PE_2018-04-17.csv,6,4,2,564.0,16702.5
BANKNIFTY19APR1825300CE_2018-04-17.csv,10,3,7,-496.5,44203.5
BANKNIFTY19APR1825300PE_2018-04-17.csv,9,4,5,497.25,36702.75
BANKNIFTY19APR1825400CE_2018-04-17.csv,8,3,5,-84.75,25393.5
BANKNIFTY19APR1825400PE_2018-04-17.csv,9,3,6,104.25,51086.25
BANKNIFTY19APR1825500CE_2018-04-17.csv,12,5,7,58.5,22744.5
BANKNIFTY19APR1825500PE_2018-04-17.csv,12,4,8,-282.75,93362.25
BANKNIFTY19APR1825600CE_2018-04-17.csv,8,3,5,-23.25,8540.25
BANKNIFTY19APR1825700CE_2018-04-17.csv,10,5,5,88.5,5794.5
BANKNIFTY19APR1825000CE_2018-04-18.csv,12,3,9,-1010.25,101532.75
BANKNIFTY19APR1825100CE_2018-04-18.csv,10,3,7,-1124.25,69074.25
BANKNIFTY19APR1825100PE_2018-04-18.csv,9,6,3,411.0,9381.0
BANKNIFTY19APR1825200CE_2018-04-18.csv,8,2,6,-369.75,36929.25
BANKNIFTY19APR1825200PE_2018-04-18.csv,9,4,5,-74.25,18351.75
BANKNIFTY19APR1825300CE_2018-04-18.csv,10,2,8,-503.25,27890.25
BANKNIFTY19APR1825300PE_2018-04-18.csv,9,6,3,851.25,29594.25
BANKNIFTY19APR1825400CE_2018-04-18.csv,7,2,5,-170.25,12412.5
BANKNIFTY19APR1825400PE_2018-04-18.csv,8,3,5,-417.75,43478.25
BANKNIFTY19APR1825500CE_2018-04-18.csv,4,0,4,-234.75,3701.25
BANKNIFTY19APR1825500PE_2018-04-18.csv,11,5,6,1191.0,87019.5
BANKNIFTY19APR1825600CE_2018-04-18.csv,10,5,5,66.0,4335.0
BANKNIFTY19APR1825600PE_2018-04-18.csv,10,4,6,985.5,105924.75
BANKNIFTY19APR1824900CE_2018-04-19.csv,16,7,9,354.75,105281.25
BANKNIFTY19APR1825000CE_2018-04-19.csv,11,4,7,-55.5,42070.5
BANKNIFTY19APR1825000PE_2018-04-19.csv,18,9,9,4.5,5190.75
BANKNIFTY19APR1825100CE_2018-04-19.csv,10,5,5,96.0,17569.5
BANKNIFTY19APR1825100PE_2018-04-19.csv,14,6,8,-91.5,12804.0
BANKNIFTY19APR1825200CE_2018-04-19.csv,17,10,7,79.5,8144.25
BANKNIFTY19APR1825200PE_2018-04-19.csv,12,1,11,-996.75,30806.25
BANKNIFTY19APR1825300CE_2018-04-19.csv,19,11,8,9.0,2294.25
BANKNIFTY19APR1825300PE_2018-04-19.csv,13,2,11,-1596.75,67784.25
BANKNIFTY19APR1825400PE_2018-04-19.csv,13,5,8,150.75,104891.25
BANKNIFTY26APR1824100PE_2018-04-20.csv,15,4,11,-71.25,10604.25
BANKNIFTY26APR1824200PE_2018-04-20.csv,12,4,8,29.25,10755.0
BANKNIFTY26APR1824300PE_2018-04-20.csv,13,4,9,-45.75,14081.25
BANKNIFTY26APR1824400PE_2018-04-20.csv,12,5,7,98.25,16685.25
BANKNIFTY26APR1824500PE_2018-04-20.csv,12,6,6,275.25,21798.75
BANKNIFTY26APR1824600PE_2018-04-20.csv,11,3,8,-178.5,25866.75
BANKNIFTY26APR1824700PE_2018-04-20.csv,9,3,6,-11.25,27527.25
BANKNIFTY26APR1824800CE_2018-04-20.csv,9,3,6,-208.5,72414.0
BANKNIFTY26APR1824800PE_2018-04-20.csv,11,4,7,56.25,42296.25
BANKNIFTY26APR1824900CE_2018-04-20.csv,8,2,6,-414.75,48246.75
BANKNIFTY26APR1824900PE_2018-04-20.csv,9,2,7,-463.5,43990.5
BANKNIFTY26APR1825000CE_2018-04-20.csv,6,3,3,303.0,27603.0
BANKNIFTY26APR1825000PE_2018-04-20.csv,8,0,8,-1484.25,48306.75
BANKNIFTY26APR1825100CE_2018-04-20.csv,8,4,4,245.25,28341.75
BANKNIFTY26APR1825100PE_2018-04-20.csv,7,1,6,-961.5,55986.0
BANKNIFTY26APR1825200CE_2018-04-20.csv,7,3,4,55.5,16350.0
BANKNIFTY26APR1825200PE_2018-04-20.csv,9,4,5,589.5,91260.75
BANKNIFTY26APR1825300CE_2018-04-20.csv,10,5,5,118.5,17130.0
BANKNIFTY26APR1825400CE_2018-04-20.csv,9,6,3,201.75,9902.25
BANKNIFTY26APR1825500CE_2018-04-20.csv,10,4,6,14.25,7257.75
BANKNIFTY26APR1825600CE_2018-04-20.csv,17,7,10,21.0,7818.0
BANKNIFTY26APR1824300PE_2018-04-23.csv,19,5,14,-99.0,10627.5
BANKNIFTY26APR1824400PE_2018-04-23.csv,14,3,11,-89.25,10113.75
BANKNIFTY26APR1824500PE_2018-04-23.csv,16,6,10,75.0,16516.5
BANKNIFTY26APR1824600PE_2018-04-23.csv,12,5,7,155.25,16704.75
BANKNIFTY26APR1824700CE_2018-04-23.csv,11,5,6,926.25,107842.5
BANKNIFTY26APR1824700PE_2018-04-23.csv,10,2,8,-432.0,17644.5
BANKNIFTY26APR1824800CE_2018-04-23.csv,11,7,4,2032.5,83850.0
BANKNIFTY26APR1824800PE_2018-04-23.csv,8,2,6,-483.0,22147.5
BANKNIFTY26APR1824900CE_2018-04-23.csv,9,4,5,255.75,52107.75
BANKNIFTY26APR1824900PE_2018-04-23.csv,10,2,8,-933.75,38879.25
BANKNIFTY26APR1825000CE_2018-04-23.csv,10,6,4,585.0,39469.5
BANKNIFTY26APR1825000PE_2018-04-23.csv,9,4,5,422.25,47583.75
BANKNIFTY26APR1825100CE_2018-04-23.csv,6,2,4,-216.75,17970.75
BANKNIFTY26APR1825100PE_2018-04-23.csv,11,2,9,-1676.25,82800.75
BANKNIFTY26APR1825200CE_2018-04-23.csv,9,5,4,203.25,17138.25
BANKNIFTY26APR1825200PE_2018-04-23.csv,11,3,8,-1453.5,99624.0
BANKNIFTY26APR1825300CE_2018-04-23.csv,9,4,5,-5.25,11261.25
BANKNIFTY26APR1825400CE_2018-04-23.csv,12,4,8,-54.0,9291.75
BANKNIFTY26APR1825500CE_2018-04-23.csv,15,7,8,2.25,7562.25
BANKNIFTY26APR1824500PE_2018-04-24.csv,13,4,9,-33.75,5805.75
BANKNIFTY26APR1824600PE_2018-04-24.csv,11,4,7,-5.25,7364.25
BANKNIFTY26APR1824700CE_2018-04-24.csv,7,2,5,-871.5,73132.5
BANKNIFTY26APR1824700PE_2018-04-24.csv,8,3,5,-2.25,8878.5
BANKNIFTY26APR1824800CE_2018-04-24.csv,7,3,4,17.25,57927.0
BANKNIFTY26APR1824800PE_2018-04-24.csv,9,2,7,-198.0,16242.0
BANKNIFTY26APR1824900CE_2018-04-24.csv,5,2,3,-117.0,30135.75
BANKNIFTY26APR1824900PE_2018-04-24.csv,7,2,5,-105.0,19419.0
BANKNIFTY26APR1825000CE_2018-04-24.csv,9,3,6,-183.0,34315.5
BANKNIFTY26APR1825000PE_2018-04-24.csv,9,4,5,234.75,35294.25
BANKNIFTY26APR1825100CE_2018-04-24.csv,9,1,8,-648.0,22812.0
BANKNIFTY26APR1825100PE_2018-04-24.csv,7,4,3,753.75,39632.25
BANKNIFTY26APR1825200CE_2018-04-24.csv,8,2,6,-257.25,13920.0
BANKNIFTY26APR1825200PE_2018-04-24.csv,6,2,4,-339.75,48241.5
BANKNIFTY26APR1825300CE_2018-04-24.csv,10,2,8,-214.5,9742.5
BANKNIFTY26APR1825300PE_2018-04-24.csv,9,4,5,827.25,92004.75
BANKNIFTY26APR1825400CE_2018-04-24.csv,14,4,10,-62.25,8150.25
BANKNIFTY26APR1824700CE_2018-04-25.csv,9,3,6,-290.25,52478.25
BANKNIFTY26APR1824700PE_2018-04-25.csv,9,4,5,79.5,9980.25
BANKNIFTY26APR1824800CE_2018-04-25.csv,8,3,5,235.5,32169.0
BANKNIFTY26APR1824800PE_2018-04-25.csv,7,3,4,-39.0,16684.5
BANKNIFTY26APR1824900CE_2018-04-25.csv,9,4,5,204.0,19600.5
BANKNIFTY26APR1824900PE_2018-04-25.csv,6,1,5,-480.75,22089.75
BANKNIFTY26APR1825000CE_2018-04-25.csv,10,2,8,-197.25,14280.0
BANKNIFTY26APR1825000PE_2018-04-25.csv,5,1,4,-702.75,27842.25
BANKNIFTY26APR1825100CE_2018-04-25.csv,12,4,8,16.5,8400.0
BANKNIFTY26APR1825100PE_2018-04-25.csv,8,3,5,-17.25,67103.25
BANKNIFTY26APR1825200CE_2018-04-25.csv,14,4,10,9.0,5578.5
BANKNIFTY26APR1825200PE_2018-04-25.csv,8,5,3,1926.0,90156.0
BANKNIFTY26APR1824500CE_2018-04-26.csv,10,4,6,352.5,93589.5
BANKNIFTY26APR1824600CE_2018-04-26.csv,14,5,9,-474.0,92392.5
BANKNIFTY26APR1824700CE_2018-04-26.csv,8,2,6,-392.25,28419.75
BANKNIFTY26APR1824700PE_2018-04-26.csv,18,12,6,-61.5,4332.75
BANKNIFTY26APR1824800CE_2018-04-26.csv,6,1,5,-295.5,9784.5
BANKNIFTY26APR1824800PE_2018-04-26.csv,14,8,6,77.25,12501.0
BANKNIFTY26APR1824900CE_2018-04-26.csv,12,5,7,168.0,9412.5
BANKNIFTY26APR1824900PE_2018-04-26.csv,9,2,7,-124.5,17123.25
BANKNIFTY26APR1825000PE_2018-04-26.csv,9,3,6,-486.0,43389.75
BANKNIFTY26APR1825100PE_2018-04-26.csv,13,5,8,-1029.75,93107.25
BANKNIFTY03MAY1824600PE_2018-04-27.csv,13,5,8,-22.5,5299.5
BANKNIFTY03MAY1824700PE_2018-04-27.csv,8,1,7,-153.75,4713.75
BANKNIFTY03MAY1824800CE_2018-04-27.csv,7,5,2,3023.25,113030.25
BANKNIFTY03MAY1824800PE_2018-04-27.csv,8,2,6,-82.5,5917.5
BANKNIFTY03MAY1824900CE_2018-04-27.csv,7,5,2,2793.0,93810.0
BANKNIFTY03MAY1824900PE_2018-04-27.csv,7,0,7,-285.0,7433.25
BANKNIFTY03MAY1825000CE_2018-04-27.csv,8,6,2,2526.75,93267.0
BANKNIFTY03MAY1825000PE_2018-04-27.csv,7,1,6,-502.5,11916.75
BANKNIFTY03MAY1825100CE_2018-04-27.csv,9,7,2,2529.0,82863.0
BANKNIFTY03MAY1825100PE_2018-04-27.csv,7,3,4,-38.25,13968.75
BANKNIFTY03MAY1825200CE_2018-04-27.csv,9,6,3,1376.25,58203.75
BANKNIFTY03MAY1825200PE_2018-04-27.csv,10,2,8,-732.0,30649.5
BANKNIFTY03MAY1825300CE_2018-04-27.csv,7,4,3,633.0,37168.5
BANKNIFTY03MAY1825300PE_2018-04-27.csv,10,2,8,-1185.75,46405.5
BANKNIFTY03MAY1825400CE_2018-04-27.csv,7,4,3,352.5,23434.5
BANKNIFTY03MAY1825400PE_2018-04-27.csv,10,1,9,-1938.0,66456.75
BANKNIFTY03MAY1825500CE_2018-04-27.csv,11,7,4,582.75,26918.25
BANKNIFTY03MAY1825500PE_2018-04-27.csv,11,1,10,-3101.25,94602.75
BANKNIFTY03MAY1825600CE_2018-04-27.csv,10,6,4,380.25,17115.75
BANKNIFTY03MAY1825700CE_2018-04-27.csv,10,5,5,136.5,10918.5
BANKNIFTY03MAY1825800CE_2018-04-27.csv,14,6,8,-2.25,9294.0
BANKNIFTY03MAY1825100PE_2018-04-30.csv,6,1,5,-26.25,2595.75
BANKNIFTY03MAY1825200PE_2018-04-30.csv,8,1,7,-119.25,4512.75
BANKNIFTY03MAY1825300CE_2018-04-30.csv,4,3,1,1115.25,35073.75
BANKNIFTY03MAY1825300PE_2018-04-30.csv,10,2,8,-168.0,8784.0
BANKNIFTY03MAY1825400CE_2018-04-30.csv,4,3,1,815.25,26033.25
BANKNIFTY03MAY1825400PE_2018-04-30.csv,7,0,7,-324.75,9717.75
BANKNIFTY03MAY1825500CE_2018-04-30.csv,7,4,3,305.25,34776.75
BANKNIFTY03MAY1825500PE_2018-04-30.csv,10,1,9,-522.0,21690.0
BANKNIFTY03MAY1825600CE_2018-04-30.csv,8,5,3,530.25,25694.25
BANKNIFTY03MAY1825600PE_2018-04-30.csv,7,1,6,-372.0,22755.0
BANKNIFTY03MAY1825700CE_2018-04-30.csv,7,5,2,378.0,14173.5
BANKNIFTY03MAY1825700PE_2018-04-30.csv,9,2,7,-546.0,47706.0
BANKNIFTY03MAY1825800CE_2018-04-30.csv,11,4,7,-38.25,11939.25
BANKNIFTY03MAY1825800PE_2018-04-30.csv,9,1,8,-1420.5,68355.0
BANKNIFTY03MAY1825200CE_2018-05-02.csv,8,3,5,2.25,96632.25
BANKNIFTY03MAY1825300CE_2018-05-02.csv,11,5,6,-89.25,102620.25
BANKNIFTY03MAY1825400CE_2018-05-02.csv,11,6,5,1077.0,79573.5
BANKNIFTY03MAY1825400PE_2018-05-02.csv,10,4,6,80.25,7701.75
BANKNIFTY03MAY1825500CE_2018-05-02.csv,5,3,2,506.25,25833.75
BANKNIFTY03MAY1825500PE_2018-05-02.csv,10,5,5,67.5,13171.5
BANKNIFTY03MAY1825600CE_2018-05-02.csv,10,4,6,-39.0,26247.75
BANKNIFTY03MAY1825600PE_2018-05-02.csv,6,3,3,153.0,14537.25
BANKNIFTY03MAY1825700CE_2018-05-02.csv,8,3,5,-25.5,10837.5
BANKNIFTY03MAY1825700PE_2018-05-02.csv,4,1,3,-157.5,18570.0
BANKNIFTY03MAY1825800CE_2018-05-02.csv,12,4,8,-40.5,7393.5
BANKNIFTY03MAY1825800PE_2018-05-02.csv,12,2,10,-1551.75,70541.25
BANKNIFTY03MAY1825900PE_2018-05-02.csv,13,5,8,141.75,115523.25
BANKNIFTY03MAY1825200CE_2018-05-03.csv,8,5,3,2099.25,95387.25
BANKNIFTY03MAY1825300CE_2018-05-03.csv,8,5,3,1804.5,69687.0
BANKNIFTY03MAY1825400CE_2018-05-03.csv,10,7,3,1526.25,52007.25
BANKNIFTY03MAY1825500CE_2018-05-03.csv,11,6,5,196.5,27406.5
BANKNIFTY03MAY1825500PE_2018-05-03.csv,16,7,9,-21.75,6558.0
BANKNIFTY03MAY1825600CE_2018-05-03.csv,13,6,7,460.5,9615.0
BANKNIFTY03MAY1825600PE_2018-05-03.csv,8,2,6,-211.5,12155.25
BANKNIFTY03MAY1825700PE_2018-05-03.csv,11,3,8,-681.0,35092.5
BANKNIFTY03MAY1825800PE_2018-05-03.csv,8,2,6,-772.5,48057.0
BANKNIFTY10MAY1825100PE_2018-05-04.csv,6,2,4,-67.5,4042.5
BANKNIFTY10MAY1825200PE_2018-05-04.csv,10,4,6,10.5,10000.5
BANKNIFTY10MAY1825300PE_2018-05-04.csv,8,3,5,-84.0,12385.5
BANKNIFTY10MAY1825400CE_2018-05-04.csv,7,4,3,732.0,62989.5
BANKNIFTY10MAY1825400PE_2018-05-04.csv,9,4,5,258.0,19918.5
BANKNIFTY10MAY1825500CE_2018-05-04.csv,10,3,7,-264.0,75052.5
BANKNIFTY10MAY1825500PE_2018-05-04.csv,6,2,4,-128.25,19185.75
BANKNIFTY10MAY1825600CE_2018-05-04.csv,6,4,2,771.75,35106.75
BANKNIFTY10MAY1825600PE_2018-05-04.csv,7,3,4,308.25,29027.25
BANKNIFTY10MAY1825700CE_2018-05-04.csv,6,3,3,276.0,22774.5
BANKNIFTY10MAY1825700PE_2018-05-04.csv,10,3,7,-660.0,55339.5
BANKNIFTY10MAY1825800CE_2018-05-04.csv,7,4,3,294.0,18207.0
BANKNIFTY10MAY1825800PE_2018-05-04.csv,11,3,8,-852.0,84148.5
BANKNIFTY10MAY1825900CE_2018-05-04.csv,8,2,6,-276.0,14636.25
BANKNIFTY10MAY1826000CE_2018-05-04.csv,7,3,4,27.0,7725.0
BANKNIFTY10MAY1825300PE_2018-05-07.csv,7,1,6,-69.75,3629.25
BANKNIFTY10MAY1825400PE_2018-05-07.csv,4,1,3,-48.75,3285.75
BANKNIFTY10MAY1825500CE_2018-05-07.csv,4,2,2,330.75,37029.75
BANKNIFTY10MAY1825500PE_2018-05-07.csv,7,1,6,-291.75,9519.75
BANKNIFTY10MAY1825600CE_2018-05-07.csv,3,2,1,716.25,21240.75
BANKNIFTY10MAY1825600PE_2018-05-07.csv,4,0,4,-360.75,8820.75
BANKNIFTY10MAY1825700CE_2018-05-07.csv,4,1,3,-198.0,19977.0
BANKNIFTY10MAY1825700PE_2018-05-07.csv,8,2,6,-300.75,24773.25
BANKNIFTY10MAY1825800CE_2018-05-07.csv,3,1,2,22.5,10150.5
BANKNIFTY10MAY1825800PE_2018-05-07.csv,6,0,6,-973.5,26383.5
BANKNIFTY10MAY1825900CE_2018-05-07.csv,3,1,2,-1.5,6634.5
BANKNIFTY10MAY1825900PE_2018-05-07.csv,6,0,6,-1167.0,36505.5
BANKNIFTY10MAY1826000CE_2018-05-07.csv,3,1,2,-19.5,4108.5
BANKNIFTY10MAY1826000PE_2018-05-07.csv,6,1,5,-834.75,51153.75
BANKNIFTY10MAY1826100CE_2018-05-07.csv,4,1,3,-24.75,3225.75
BANKNIFTY10MAY1825600PE_2018-05-08.csv,10,2,8,-113.25,7371.75
BANKNIFTY10MAY1825700CE_2018-05-08.csv,7,5,2,1818.0,66126.75
BANKNIFTY10MAY1825700PE_2018-05-08.csv,9,1,8,-197.25,10503.75
BANKNIFTY10MAY1825800CE_2018-05-08.csv,11,7,4,1515.0,74527.5
BANKNIFTY10MAY1825800PE_2018-05-08.csv,6,2,4,54.0,11004.0
BANKNIFTY10MAY1825900CE_2018-05-08.csv,6,3,3,150.0,29376.75
BANKNIFTY10MAY1825900PE_2018-05-08.csv,5,0,5,-471.0,13348.5
BANKNIFTY10MAY1826000CE_2018-05-08.csv,6,3,3,69.0,16936.5
BANKNIFTY10MAY1826000PE_2018-05-08.csv,7,1,6,-606.0,27120.0
BANKNIFTY10MAY1826100CE_2018-05-08.csv,8,3,5,-57.0,14106.0
BANKNIFTY10MAY1826100PE_2018-05-08.csv,9,3,6,-70.5,50293.5
BANKNIFTY10MAY1826200CE_2018-05-08.csv,8,4,4,18.0,7837.5
BANKNIFTY10MAY1826200PE_2018-05-08.csv,11,3,8,-395.25,84110.25
BANKNIFTY10MAY1825700CE_2018-05-09.csv,7,5,2,2144.25,79047.0
BANKNIFTY10MAY1825700PE_2018-05-09.csv,8,1,7,-63.75,2439.75
BANKNIFTY10MAY1825800CE_2018-05-09.csv,7,5,2,1483.5,62131.5
BANKNIFTY10MAY1825800PE_2018-05-09.csv,10,1,9,-202.5,5415.0
BANKNIFTY10MAY1825900CE_2018-05-09.csv,8,6,2,1345.5,47962.5
BANKNIFTY10MAY1825900PE_2018-05-09.csv,5,0,5,-197.25,4681.5
BANKNIFTY10MAY1826000CE_2018-05-09.csv,9,5,4,321.75,32353.5
BANKNIFTY10MAY1826000PE_2018-05-09.csv,8,0,8,-732.75,14229.75
BANKNIFTY10MAY1826100CE_2018-05-09.csv,9,5,4,212.25,18759.75
BANKNIFTY10MAY1826100PE_2018-05-09.csv,10,1,9,-884.25,33347.25
BANKNIFTY10MAY1826200CE_2018-05-09.csv,13,5,8,-47.25,12750.75
BANKNIFTY10MAY1826200PE_2018-05-09.csv,9,0,9,-1641.75,48411.75
BANKNIFTY10MAY1826300PE_2018-05-09.csv,6,0,6,-1455.75,50313.0
BANKNIFTY10MAY1825900CE_2018-05-10.csv,11,5,6,459.75,81450.75
BANKNIFTY10MAY1826000CE_2018-05-10.csv,10,5,5,480.0,47559.0
BANKNIFTY10MAY1826100CE_2018-05-10.csv,9,2,7,-380.25,21098.25
BANKNIFTY10MAY1826100PE_2018-05-10.csv,20,8,12,21.75,5925.0
BANKNIFTY10MAY1826200CE_2018-05-10.csv,22,9,13,-145.5,13271.25
BANKNIFTY10MAY1826200PE_2018-05-10.csv,10,4,6,41.25,15434.25
BANKNIFTY10MAY1826300PE_2018-05-10.csv,9,3,6,-189.0,35326.5
BANKNIFTY10MAY1826400PE_2018-05-10.csv,10,4,6,510.75,68691.0
BANKNIFTY10MAY1826500PE_2018-05-10.csv,9,4,5,963.75,92219.25
BANKNIFTY17MAY1825200PE_2018-05-11.csv,12,3,9,-148.5,8752.5
BANKNIFTY17MAY1825300PE_2018-05-11.csv,10,1,9,-305.25,8750.25
BANKNIFTY17MAY1825400PE_2018-05-11.csv,10,2,8,-267.75,11106.75
BANKNIFTY17MAY1825500PE_2018-05-11.csv,8,2,6,-229.5,11830.5
BANKNIFTY17MAY1825600PE_2018-05-11.csv,9,2,7,-370.5,15768.0
BANKNIFTY17MAY1825700PE_2018-05-11.csv,10,2,8,-435.0,24361.5
BANKNIFTY17MAY1825800PE_2018-05-11.csv,9,2,7,-369.0,27274.5
BANKNIFTY17MAY1825900PE_2018-05-11.csv,9,2,7,-538.5,33520.5
BANKNIFTY17MAY1826000CE_2018-05-11.csv,5,2,3,71.25,60417.75
BANKNIFTY17MAY1826000PE_2018-05-11.csv,6,1,5,-598.5,30190.5
BANKNIFTY17MAY1826100CE_2018-05-11.csv,7,3,4,403.5,72094.5
BANKNIFTY17MAY1826100PE_2018-05-11.csv,6,0,6,-1408.5,33256.5
BANKNIFTY17MAY1826200CE_2018-05-11.csv,5,1,4,-381.75,41584.5
BANKNIFTY17MAY1826200PE_2018-05-11.csv,7,1,6,-1258.5,54664.5
BANKNIFTY17MAY1826300CE_2018-05-11.csv,3,1,2,51.0,19962.75
BANKNIFTY17MAY1826300PE_2018-05-11.csv,7,1,6,-1353.75,68373.0
BANKNIFTY17MAY1826400CE_2018-05-11.csv,7,2,5,-315.0,37593.0
BANKNIFTY17MAY1826500CE_2018-05-11.csv,5,2,3,18.75,20478.0
BANKNIFTY17MAY1826600CE_2018-05-11.csv,6,2,4,-89.25,17436.0
BANKNIFTY17MAY1826700CE_2018-05-11.csv,9,3,6,-163.5,20148.75
BANKNIFTY17MAY1826800CE_2018-05-11.csv,8,3,5,-111.0,13029.0
BANKNIFTY17MAY1826900CE_2018-05-11.csv,7,2,5,-118.5,8370.75
BANKNIFTY17MAY1825400PE_2018-05-14.csv,17,8,9,123.0,10473.75
BANKNIFTY17MAY1825500PE_2018-05-14.csv,12,8,4,218.25,9605.25
BANKNIFTY17MAY1825600PE_2018-05-14.csv,13,8,5,270.0,12615.0
BANKNIFTY17MAY1825700PE_2018-05-14.csv,13,8,5,384.75,16080.75
BANKNIFTY17MAY1825800PE_2018-05-14.csv,12,7,5,435.0,18307.5
BANKNIFTY17MAY1825900PE_2018-05-14.csv,10,7,3,516.0,19320.0
BANKNIFTY17MAY1826000PE_2018-05-14.csv,11,4,7,-23.25,28471.5
BANKNIFTY17MAY1826100PE_2018-05-14.csv,8,5,3,483.75,25145.25
BANKNIFTY17MAY1826200CE_2018-05-14.csv,6,2,4,-169.5,71935.5
BANKNIFTY17MAY1826200PE_2018-05-14.csv,8,4,4,277.5,31182.0
BANKNIFTY17MAY1826300CE_2018-05-14.csv,8,3,5,-9.0,71683.5
BANKNIFTY17MAY1826300PE_2018-05-14.csv,9,5,4,673.5,47197.5
BANKNIFTY17MAY1826400CE_2018-05-14.csv,8,3,5,-47.25,57792.75
BANKNIFTY17MAY1826400PE_2018-05-14.csv,12,7,5,1324.5,73590.0
BANKNIFTY17MAY1826500CE_2018-05-14.csv,6,2,4,-99.0,37303.5
BANKNIFTY17MAY1826500PE_2018-05-14.csv,7,3,4,343.5,52560.0
BANKNIFTY17MAY1826600CE_2018-05-14.csv,7,2,5,-184.5,30996.0
BANKNIFTY17MAY1826600PE_2018-05-14.csv,5,3,2,821.25,49393.5
BANKNIFTY17MAY1826700CE_2018-05-14.csv,5,2,3,-33.0,16891.5
BANKNIFTY17MAY1826800CE_2018-05-14.csv,8,4,4,180.75,19922.25
BANKNIFTY17MAY1826900CE_2018-05-14.csv,8,2,6,-160.5,14140.5
BANKNIFTY17MAY1827000CE_2018-05-14.csv,7,2,5,-81.75,8706.75
BANKNIFTY17MAY1827100CE_2018-05-14.csv,10,4,6,27.0,8844.75
BANKNIFTY17MAY1825600PE_2018-05-15.csv,24,12,12,-15.75,4935.75
BANKNIFTY17MAY1825700PE_2018-05-15.csv,19,10,9,53.25,4457.25
BANKNIFTY17MAY1825800PE_2018-05-15.csv,10,3,7,-14.25,2747.25
BANKNIFTY17MAY1825900PE_2018-05-15.csv,10,5,5,21.0,3584.25
BANKNIFTY17MAY1826000PE_2018-05-15.csv,9,4,5,-58.5,4890.0
BANKNIFTY17MAY1826100PE_2018-05-15.csv,6,2,4,1.5,4071.0
BANKNIFTY17MAY1826200CE_2018-05-15.csv,14,2,12,-4250.25,198846.0
BANKNIFTY17MAY1826200PE_2018-05-15.csv,13,5,8,-60.0,11551.5
BANKNIFTY17MAY1826300CE_2018-05-15.csv,15,3,12,-3192.0,182521.5
BANKNIFTY17MAY1826300PE_2018-05-15.csv,8,4,4,-36.75,9668.25
BANKNIFTY17MAY1826400CE_2018-05-15.csv,12,2,10,-2283.0,104200.5
BANKNIFTY17MAY1826400PE_2018-05-15.csv,9,3,6,-254.25,16023.75
BANKNIFTY17MAY1826500CE_2018-05-15.csv,10,0,10,-2640.0,70035.0
BANKNIFTY17MAY1826500PE_2018-05-15.csv,6,4,2,412.5,17194.5
BANKNIFTY17MAY1826600CE_2018-05-15.csv,15,3,12,-1926.75,72762.75
BANKNIFTY17MAY1826600PE_2018-05-15.csv,10,3,7,-792.75,41524.5
BANKNIFTY17MAY1826700CE_2018-05-15.csv,10,2,8,-964.5,37947.0
BANKNIFTY17MAY1826700PE_2018-05-15.csv,9,3,6,-576.0,45730.5
BANKNIFTY17MAY1826800CE_2018-05-15.csv,12,2,10,-996.0,31987.5
BANKNIFTY17MAY1826800PE_2018-05-15.csv,10,4,6,-21.0,87076.5
BANKNIFTY17MAY1826900CE_2018-05-15.csv,12,3,9,-419.25,24012.75
BANKNIFTY17MAY1826900PE_2018-05-15.csv,13,4,9,-1263.75,116939.25
BANKNIFTY17MAY1827000CE_2018-05-15.csv,12,2,10,-502.5,14034.0
BANKNIFTY17MAY1827000PE_2018-05-15.csv,19,8,11,-842.25,224765.25
BANKNIFTY17MAY1827100CE_2018-05-15.csv,13,3,10,-335.25,10214.25
BANKNIFTY17MAY1827200CE_2018-05-15.csv,18,5,13,-99.75,9287.25
BANKNIFTY17MAY1827300CE_2018-05-15.csv,21,11,10,75.75,5565.75
BANKNIFTY17MAY1825900PE_2018-05-16.csv,7,4,3,33.0,4203.0
BANKNIFTY17MAY1826000CE_2018-05-16.csv,13,3,10,-1644.0,117033.0
BANKNIFTY17MAY1826000PE_2018-05-16.csv,0,0,0,0.0,0.0
BANKNIFTY17MAY1826100CE_2018-05-16.csv,9,3,6,-1115.25,64845.0
BANKNIFTY17MAY1826100PE_2018-05-16.csv,2,0,2,-174.0,3183.0
BANKNIFTY17MAY1826200CE_2018-05-16.csv,12,5,7,-781.5,52596.0
BANKNIFTY17MAY1826200PE_2018-05-16.csv,4,0,4,-370.5,9619.5
BANKNIFTY17MAY1826300CE_2018-05-16.csv,11,5,6,-341.25,31701.75
BANKNIFTY17MAY1826300PE_2018-05-16.csv,4,1,3,-246.75,17713.5
BANKNIFTY17MAY1826400CE_2018-05-16.csv,11,7,4,199.5,18093.0
BANKNIFTY17MAY1826400PE_2018-05-16.csv,7,3,4,651.0,45793.5
BANKNIFTY17MAY1826500CE_2018-05-16.csv,11,7,4,-87.0,9877.5
BANKNIFTY17MAY1826500PE_2018-05-16.csv,8,2,6,-575.25,65864.25
BANKNIFTY17MAY1826600CE_2018-05-16.csv,13,7,6,-77.25,6012.75
BANKNIFTY17MAY1826600PE_2018-05-16.csv,14,4,10,-1513.5,139438.5
BANKNIFTY17MAY1825900CE_2018-05-17.csv,21,6,15,-2660.25,139401.75
BANKNIFTY17MAY1826000CE_2018-05-17.csv,11,5,6,175.5,45429.0
BANKNIFTY17MAY1826100CE_2018-05-17.csv,10,4,6,-420.0,12294.75
BANKNIFTY17MAY1826100PE_2018-05-17.csv,17,9,8,145.5,10749.0
BANKNIFTY17MAY1826200CE_2018-05-17.csv,14,4,10,-168.75,11062.5
BANKNIFTY17MAY1826200PE_2018-05-17.csv,13,5,8,-113.25,30249.0
BANKNIFTY17MAY1826300CE_2018-05-17.csv,29,13,16,-165.0,2985.75
BANKNIFTY17MAY1826300PE_2018-05-17.csv,10,6,4,1120.5,40906.5
BANKNIFTY17MAY1826400PE_2018-05-17.csv,12,7,5,1695.75,93294.75
BANKNIFTY17MAY1826500PE_2018-05-17.csv,11,6,5,1951.5,113634.0
BANKNIFTY24MAY1825200PE_2018-05-18.csv,12,6,6,90.75,9756.75
BANKNIFTY24MAY1825300PE_2018-05-18.csv,11,5,6,59.25,11735.25
BANKNIFTY24MAY1825400PE_2018-05-18.csv,8,2,6,-191.25,11702.25
BANKNIFTY24MAY1825500PE_2018-05-18.csv,9,5,4,206.25,17360.25
BANKNIFTY24MAY1825600PE_2018-05-18.csv,10,6,4,420.75,27180.75
BANKNIFTY24MAY1825700PE_2018-05-18.csv,10,4,6,25.5,34402.5
BANKNIFTY24MAY1825800CE_2018-05-18.csv,12,2,10,-1582.5,88204.5
BANKNIFTY24MAY1825800PE_2018-05-18.csv,11,4,7,-102.0,50838.75
BANKNIFTY24MAY1825900CE_2018-05-18.csv,11,2,9,-922.5,59359.5
BANKNIFTY24MAY1825900PE_2018-05-18.csv,8,3,5,-135.75,46061.25
BANKNIFTY24MAY1826000CE_2018-05-18.csv,9,3,6,-240.0,37552.5
BANKNIFTY24MAY1826000PE_2018-05-18.csv,9,4,5,434.25,69306.75
BANKNIFTY24MAY1826100CE_2018-05-18.csv,10,3,7,-214.5,29038.5
BANKNIFTY24MAY1826100PE_2018-05-18.csv,11,4,7,-122.25,99087.75
BANKNIFTY24MAY1826200CE_2018-05-18.csv,7,1,6,-328.5,14148.0
BANKNIFTY24MAY1826200PE_2018-05-18.csv,9,4,5,564.0,98653.5
BANKNIFTY24MAY1826300CE_2018-05-18.csv,10,3,7,-144.0,14743.5
BANKNIFTY24MAY1826400CE_2018-05-18.csv,13,6,7,125.25,12932.25
BANKNIFTY24MAY1826500CE_2018-05-18.csv,12,2,10,-157.5,8209.5
BANKNIFTY24MAY1825300PE_2018-05-21.csv,9,2,7,-86.25,7367.25
BANKNIFTY24MAY1825400PE_2018-05-21.csv,11,4,7,-45.75,12941.25
BANKNIFTY24MAY1825500PE_2018-05-21.csv,11,3,8,-153.0,19186.5
BANKNIFTY24MAY1825600CE_2018-05-21.csv,11,2,9,-2554.5,105711.75
BANKNIFTY24MAY1825600PE_2018-05-21.csv,11,5,6,322.5,26508.0
BANKNIFTY24MAY1825700CE_2018-05-21.csv,12,4,8,-906.0,88244.25
BANKNIFTY24MAY1825700PE_2018-05-21.csv,9,4,5,242.25,31399.5
BANKNIFTY24MAY1825800CE_2018-05-21.csv,10,5,5,417.0,54951.0
BANKNIFTY24MAY1825800PE_2018-05-21.csv,7,3,4,321.75,35118.75
BANKNIFTY24MAY1825900CE_2018-05-21.csv,10,4,6,-105.75,36329.25
BANKNIFTY24MAY1825900PE_2018-05-21.csv,10,4,6,258.75,63807.0
BANKNIFTY24MAY1826000CE_2018-05-21.csv,13,4,9,-489.0,35926.5
BANKNIFTY24MAY1826000PE_2018-05-21.csv,9,4,5,744.75,74852.25
BANKNIFTY24MAY1826100CE_2018-05-21.csv,10,4,6,-117.75,17363.25
BANKNIFTY24MAY1826100PE_2018-05-21.csv,9,3,6,-27.0,92484.0
BANKNIFTY24MAY1826200CE_2018-05-21.csv,12,4,8,-127.5,14041.5
BANKNIFTY24MAY1826200PE_2018-05-21.csv,10,4,6,342.0,131149.5
BANKNIFTY24MAY1826300CE_2018-05-21.csv,11,3,8,-102.75,8745.0
BANKNIFTY24MAY1826400CE_2018-05-21.csv,11,3,8,-75.0,5403.0
BANKNIFTY24MAY1825400PE_2018-05-22.csv,11,2,9,-123.75,6105.75
BANKNIFTY24MAY1825500CE_2018-05-22.csv,14,7,7,615.75,155445.0
BANKNIFTY24MAY1825500PE_2018-05-22.csv,11,4,7,-57.75,10418.25
BANKNIFTY24MAY1825600CE_2018-05-22.csv,9,3,6,-651.75,79977.0
BANKNIFTY24MAY1825600PE_2018-05-22.csv,13,6,7,100.5,18841.5
BANKNIFTY24MAY1825700CE_2018-05-22.csv,7,2,5,-894.0,46239.75
BANKNIFTY24MAY1825700PE_2018-05-22.csv,9,4,5,235.5,19416.0
BANKNIFTY24MAY1825800CE_2018-05-22.csv,6,2,4,-243.75,27737.25
BANKNIFTY24MAY1825800PE_2018-05-22.csv,14,5,9,2.25,44246.25
BANKNIFTY24MAY1825900CE_2018-05-22.csv,6,3,3,84.75,19711.5
BANKNIFTY24MAY1825900PE_2018-05-22.csv,11,4,7,-3.0,51061.5
BANKNIFTY24MAY1826000CE_2018-05-22.csv,6,2,4,-126.75,11783.25
BANKNIFTY24MAY1826000PE_2018-05-22.csv,11,4,7,117.75,73959.75
BANKNIFTY24MAY1826100CE_2018-05-22.csv,6,2,4,-1.5,6993.0
BANKNIFTY24MAY1826100PE_2018-05-22.csv,14,4,10,-604.5,124225.5
BANKNIFTY24MAY1826200CE_2018-05-22.csv,9,3,6,-71.25,5916.75
BANKNIFTY24MAY1825500CE_2018-05-23.csv,14,4,10,-630.75,108765.75
BANKNIFTY24MAY1825500PE_2018-05-23.csv,13,5,8,-52.5,7491.0
BANKNIFTY24MAY1825600CE_2018-05-23.csv,16,4,12,-1052.25,94229.25
BANKNIFTY24MAY1825600PE_2018-05-23.csv,8,5,3,234.0,9475.5
BANKNIFTY24MAY1825700CE_2018-05-23.csv,12,2,10,-885.0,46327.5
BANKNIFTY24MAY1825700PE_2018-05-23.csv,9,5,4,305.25,18549.75
BANKNIFTY24MAY1825800CE_2018-05-23.csv,12,3,9,-305.25,30056.25
BANKNIFTY24MAY1825800PE_2018-05-23.csv,11,6,5,576.75,34409.25
BANKNIFTY24MAY1825900CE_2018-05-23.csv,12,3,9,-284.25,15267.75
BANKNIFTY24MAY1825900PE_2018-05-23.csv,11,3,8,-420.0,55668.0
BANKNIFTY24MAY1826000CE_2018-05-23.csv,10,0,10,-229.5,5328.0
BANKNIFTY24MAY1826000PE_2018-05-23.csv,12,5,7,501.0,86016.0
BANKNIFTY24MAY1826100PE_2018-05-23.csv,15,7,8,1920.75,150054.75
BANKNIFTY24MAY1825500CE_2018-05-24.csv,12,10,2,3966.0,101926.5
BANKNIFTY24MAY1825600CE_2018-05-24.csv,13,6,7,756.75,58281.75
BANKNIFTY24MAY1825600PE_2018-05-24.csv,32,15,17,-64.5,3677.25
BANKNIFTY24MAY1825700CE_2018-05-24.csv,13,6,7,147.75,33920.25
BANKNIFTY24MAY1825700PE_2018-05-24.csv,13,3,10,-156.75,5925.0
BANKNIFTY24MAY1825800PE_2018-05-24.csv,13,5,8,-298.5,18000.75
BANKNIFTY24MAY1825900PE_2018-05-24.csv,12,6,6,-519.75,36090.0
BANKNIFTY24MAY1826000PE_2018-05-24.csv,12,0,12,-2430.75,62094.0
BANKNIFTY31MAY1825500PE_2018-05-25.csv,8,0,8,-177.75,4733.25
BANKNIFTY31MAY1825600PE_2018-05-25.csv,10,3,7,-60.75,8250.75
BANKNIFTY31MAY1825700PE_2018-05-25.csv,10,3,7,-87.0,10570.5
BANKNIFTY31MAY1825800CE_2018-05-25.csv,6,4,2,1812.0,73441.5
BANKNIFTY31MAY1825800PE_2018-05-25.csv,9,1,8,-371.25,12233.25
BANKNIFTY31MAY1825900CE_2018-05-25.csv,10,4,6,301.5,98938.5
BANKNIFTY31MAY1825900PE_2018-05-25.csv,10,4,6,-88.5,18054.0
BANKNIFTY31MAY1826000CE_2018-05-25.csv,8,4,4,537.75,66410.25
BANKNIFTY31MAY1826000PE_2018-05-25.csv,8,4,4,79.5,21802.5
BANKNIFTY31MAY1826100CE_2018-05-25.csv,7,4,3,604.5,39055.5
BANKNIFTY31MAY1826100PE_2018-05-25.csv,8,3,5,7.5,31560.0
BANKNIFTY31MAY1826200CE_2018-05-25.csv,8,2,6,-361.5,34137.0
BANKNIFTY31MAY1826200PE_2018-05-25.csv,12,2,10,-1432.5,66780.0
BANKNIFTY31MAY1826300CE_2018-05-25.csv,7,4,3,336.75,21147.75
BANKNIFTY31MAY1826300PE_2018-05-25.csv,14,3,11,-1611.75,100662.75
BANKNIFTY31MAY1826400CE_2018-05-25.csv,7,4,3,104.25,14946.75
BANKNIFTY31MAY1826500CE_2018-05-25.csv,12,7,5,236.25,19989.75
BANKNIFTY31MAY1826600CE_2018-05-25.csv,11,5,6,58.5,11329.5
BANKNIFTY31MAY1825900PE_2018-05-28.csv,7,3,4,12.75,3275.25
BANKNIFTY31MAY1826000PE_2018-05-28.csv,8,4,4,54.75,5718.75
BANKNIFTY31MAY1826100CE_2018-05-28.csv,9,5,4,1650.0,115888.5
BANKNIFTY31MAY1826100PE_2018-05-28.csv,10,2,8,-142.5,8587.5
BANKNIFTY31MAY1826200CE_2018-05-28.csv,6,4,2,1581.0,66489.0
BANKNIFTY31MAY1826200PE_2018-05-28.csv,6,1,5,-162.75,6854.25
BANKNIFTY31MAY1826300CE_2018-05-28.csv,7,4,3,861.0,53169.0
BANKNIFTY31MAY1826300PE_2018-05-28.csv,7,3,4,66.75,12542.25
BANKNIFTY31MAY1826400CE_2018-05-28.csv,8,3,5,-6.75,46697.25
BANKNIFTY31MAY1826400PE_2018-05-28.csv,8,4,4,248.25,23216.25
BANKNIFTY31MAY1826500CE_2018-05-28.csv,8,5,3,710.25,33105.75
BANKNIFTY31MAY1826500PE_2018-05-28.csv,8,2,6,-426.75,35400.75
BANKNIFTY31MAY1826600CE_2018-05-28.csv,6,2,4,-120.75,19679.25
BANKNIFTY31MAY1826600PE_2018-05-28.csv,9,1,8,-1797.0,60526.5
BANKNIFTY31MAY1826700CE_2018-05-28.csv,8,3,5,-51.0,17529.0
BANKNIFTY31MAY1826700PE_2018-05-28.csv,10,0,10,-2607.0,77818.5
BANKNIFTY31MAY1826800CE_2018-05-28.csv,13,3,10,-261.75,16242.75
BANKNIFTY31MAY1826100CE_2018-05-29.csv,13,3,10,-1587.0,110718.0
BANKNIFTY31MAY1826100PE_2018-05-29.csv,11,6,5,298.5,14272.5
BANKNIFTY31MAY1826200CE_2018-05-29.csv,14,5,9,95.25,96132.75
BANKNIFTY31MAY1826200PE_2018-05-29.csv,9,4,5,486.0,19273.5
BANKNIFTY31MAY1826300CE_2018-05-29.csv,10,4,6,166.5,52629.0
BANKNIFTY31MAY1826300PE_2018-05-29.csv,10,6,4,958.5,32068.5
BANKNIFTY31MAY1826400CE_2018-05-29.csv,8,3,5,-106.5,30529.5
BANKNIFTY31MAY1826400PE_2018-05-29.csv,10,4,6,504.0,46189.5
BANKNIFTY31MAY1826500CE_2018-05-29.csv,13,5,8,31.5,27579.0
BANKNIFTY31MAY1826500PE_2018-05-29.csv,11,5,6,1170.75,71675.25
BANKNIFTY31MAY1826600CE_2018-05-29.csv,9,4,5,150.0,12823.5
BANKNIFTY31MAY1826600PE_2018-05-29.csv,10,4,6,843.0,88531.5
BANKNIFTY31MAY1826700CE_2018-05-29.csv,8,2,6,-74.25,6801.75
BANKNIFTY31MAY1826700PE_2018-05-29.csv,10,2,8,-1625.25,109392.75
BANKNIFTY31MAY1826800CE_2018-05-29.csv,13,3,10,-129.75,6923.25
BANKNIFTY31MAY1825600PE_2018-05-30.csv,17,9,8,31.5,5845.5
BANKNIFTY31MAY1825700PE_2018-05-30.csv,12,1,11,-285.75,7557.75
BANKNIFTY31MAY1825800CE_2018-05-30.csv,15,7,8,-813.75,153024.0
BANKNIFTY31MAY1825800PE_2018-05-30.csv,13,3,10,-252.75,12576.75
BANKNIFTY31MAY1825900CE_2018-05-30.csv,13,5,8,-1031.25,105050.25
BANKNIFTY31MAY1825900PE_2018-05-30.csv,9,3,6,-188.25,13410.75
BANKNIFTY31MAY1826000CE_2018-05-30.csv,8,6,2,-138.0,43524.0
BANKNIFTY31MAY1826000PE_2018-05-30.csv,11,4,7,-221.25,22065.75
BANKNIFTY31MAY1826100CE_2018-05-30.csv,10,5,5,-216.0,42527.25
BANKNIFTY31MAY1826100PE_2018-05-30.csv,13,4,9,-550.5,42825.0
BANKNIFTY31MAY1826200CE_2018-05-30.csv,8,1,7,-1523.25,23054.25
BANKNIFTY31MAY1826200PE_2018-05-30.csv,14,4,10,-1116.0,58065.0
BANKNIFTY31MAY1826300CE_2018-05-30.csv,9,3,6,-949.5,15006.0
BANKNIFTY31MAY1826300PE_2018-05-30.csv,15,2,13,-2469.0,99850.5
BANKNIFTY31MAY1826400CE_2018-05-30.csv,12,4,8,-500.25,12492.75
BANKNIFTY31MAY1826400PE_2018-05-30.csv,12,1,11,-2762.25,111636.0
BANKNIFTY31MAY1826100CE_2018-05-31.csv,11,6,5,2201.25,131097.75
BANKNIFTY31MAY1826200CE_2018-05-31.csv,9,5,4,150.0,69031.5
BANKNIFTY31MAY1826200PE_2018-05-31.csv,31,19,12,172.5,5710.5
BANKNIFTY31MAY1826300CE_2018-05-31.csv,7,3,4,-268.5,40182.0
BANKNIFTY31MAY1826300PE_2018-05-31.csv,28,11,17,-9.75,10098.75
BANKNIFTY31MAY1826400CE_2018-05-31.csv,3,1,2,-98.25,19070.25
BANKNIFTY31MAY1826400PE_2018-05-31.csv,19,8,11,-330.75,13669.5
BANKNIFTY31MAY1826500CE_2018-05-31.csv,3,2,1,116.25,4518.75
BANKNIFTY31MAY1826500PE_2018-05-31.csv,18,8,10,-381.0,30530.25
BANKNIFTY31MAY1826600CE_2018-05-31.csv,7,2,5,-6.75,9735.75
BANKNIFTY31MAY1826600PE_2018-05-31.csv,13,6,7,-438.0,38364.0
BANKNIFTY31MAY1826700CE_2018-05-31.csv,6,3,3,18.75,4551.75
BANKNIFTY31MAY1826700PE_2018-05-31.csv,14,3,11,-1944.75,71410.5
BANKNIFTY07JUN1825700PE_2018-06-01.csv,19,10,9,128.25,12461.25
BANKNIFTY07JUN1825800PE_2018-06-01.csv,17,7,10,-66.0,14516.25
BANKNIFTY07JUN1825900PE_2018-06-01.csv,15,7,8,36.75,16873.5
BANKNIFTY07JUN1826000PE_2018-06-01.csv,9,4,5,91.5,12039.0
BANKNIFTY07JUN1826100PE_2018-06-01.csv,9,5,4,47.25,15582.75
BANKNIFTY07JUN1826200PE_2018-06-01.csv,11,5,6,81.75,25046.25
BANKNIFTY07JUN1826300PE_2018-06-01.csv,13,5,8,-294.0,38474.25
BANKNIFTY07JUN1826400PE_2018-06-01.csv,7,3,4,144.75,26597.25
BANKNIFTY07JUN1826500CE_2018-06-01.csv,14,5,9,-510.75,153965.25
BANKNIFTY07JUN1826500PE_2018-06-01.csv,7,3,4,71.25,33129.75
BANKNIFTY07JUN1826600CE_2018-06-01.csv,16,7,9,573.75,143424.75
BANKNIFTY07JUN1826600PE_2018-06-01.csv,8,2,6,-779.25,46053.75
BANKNIFTY07JUN1826700CE_2018-06-01.csv,13,5,8,-61.5,98710.5
BANKNIFTY07JUN1826700PE_2018-06-01.csv,9,3,6,-437.25,67311.75
BANKNIFTY07JUN1826800CE_2018-06-01.csv,12,6,6,996.0,76392.75
BANKNIFTY07JUN1826800PE_2018-06-01.csv,10,2,8,-1958.25,90439.5
BANKNIFTY07JUN1826900CE_2018-06-01.csv,14,5,9,-254.25,71042.25
BANKNIFTY07JUN1826900PE_2018-06-01.csv,14,6,8,330.0,150723.75
BANKNIFTY07JUN1827000CE_2018-06-01.csv,8,3,5,-60.0,34107.0
BANKNIFTY07JUN1827100CE_2018-06-01.csv,16,5,11,-618.75,54662.25
BANKNIFTY07JUN1827200CE_2018-06-01.csv,14,7,7,325.5,37786.5
BANKNIFTY07JUN1827300CE_2018-06-01.csv,18,9,9,292.5,38286.0
BANKNIFTY07JUN1827400CE_2018-06-01.csv,14,6,8,38.25,24412.5
BANKNIFTY07JUN1827500CE_2018-06-01.csv,15,4,11,-321.75,18729.75
BANKNIFTY07JUN1827600CE_2018-06-01.csv,17,5,12,-120.75,16986.75
BANKNIFTY07JUN1827700CE_2018-06-01.csv,24,7,17,-73.5,17469.0
BANKNIFTY07JUN1827800CE_2018-06-01.csv,24,7,17,-110.25,12465.75
BANKNIFTY07JUN1825600PE_2018-06-04.csv,18,6,12,-165.0,15385.5
BANKNIFTY07JUN1825700PE_2018-06-04.csv,20,8,12,26.25,22408.5
BANKNIFTY07JUN1825800PE_2018-06-04.csv,10,3,7,-144.75,17252.25
BANKNIFTY07JUN1825900PE_2018-06-04.csv,13,5,8,63.75,29583.75
BANKNIFTY07JUN1826000PE_2018-06-04.csv,10,1,9,-717.0,28668.75
BANKNIFTY07JUN1826100PE_2018-06-04.csv,13,5,8,406.5,49182.0
BANKNIFTY07JUN1826200PE_2018-06-04.csv,11,4,7,-18.0,54756.0
BANKNIFTY07JUN1826300CE_2018-06-04.csv,18,6,12,-2656.5,163675.5
BANKNIFTY07JUN1826300PE_2018-06-04.csv,9,3,6,-108.0,56532.0
BANKNIFTY07JUN1826400CE_2018-06-04.csv,12,5,7,-925.5,89450.25
BANKNIFTY07JUN1826400PE_2018-06-04.csv,11,4,7,29.25,81927.75
BANKNIFTY07JUN1826500CE_2018-06-04.csv,8,3,5,-557.25,42987.75
BANKNIFTY07JUN1826500PE_2018-06-04.csv,10,3,7,-342.0,100341.0
BANKNIFTY07JUN1826600CE_2018-06-04.csv,9,4,5,-244.5,38472.0
BANKNIFTY07JUN1826600PE_2018-06-04.csv,9,4,5,846.0,107514.0
BANKNIFTY07JUN1826700CE_2018-06-04.csv,7,3,4,-132.75,26303.25
BANKNIFTY07JUN1826700PE_2018-06-04.csv,11,7,4,3406.5,144831.0
BANKNIFTY07JUN1826800CE_2018-06-04.csv,5,1,4,-568.5,16287.0
BANKNIFTY07JUN1826800PE_2018-06-04.csv,9,4,5,1047.75,143007.75
BANKNIFTY07JUN1826900CE_2018-06-04.csv,9,6,3,211.5,21161.25
BANKNIFTY07JUN1826900PE_2018-06-04.csv,10,4,6,592.5,190753.5
BANKNIFTY07JUN1827000CE_2018-06-04.csv,10,6,4,111.0,17953.5
BANKNIFTY07JUN1827000PE_2018-06-04.csv,9,4,5,1240.5,196440.75
BANKNIFTY07JUN1827100CE_2018-06-04.csv,8,4,4,-84.0,11215.5
BANKNIFTY07JUN1827200CE_2018-06-04.csv,10,5,5,-79.5,10931.25
BANKNIFTY07JUN1827300CE_2018-06-04.csv,8,2,6,-181.5,6099.0
BANKNIFTY07JUN1827400CE_2018-06-04.csv,11,4,7,-120.0,5767.5
BANKNIFTY07JUN1827500CE_2018-06-04.csv,12,4,8,-82.5,5320.5
BANKNIFTY07JUN1827600CE_2018-06-04.csv,10,4,6,-33.75,2526.75
BANKNIFTY07JUN1827700CE_2018-06-04.csv,15,5,10,-54.0,2614.5
BANKNIFTY07JUN1825500PE_2018-06-05.csv,12,7,5,125.25,7714.5
BANKNIFTY07JUN1825600PE_2018-06-05.csv,13,6,7,91.5,11886.0
BANKNIFTY07JUN1825700PE_2018-06-05.csv,11,7,4,231.0,12997.5
BANKNIFTY07JUN1825800PE_2018-06-05.csv,10,5,5,195.0,17832.75
BANKNIFTY07JUN1825900PE_2018-06-05.csv,9,3,6,-147.0,21366.0
BANKNIFTY07JUN1826000CE_2018-06-05.csv,8,2,6,-656.25,76552.5
BANKNIFTY07JUN1826000PE_2018-06-05.csv,10,4,6,-57.75,35391.75
BANKNIFTY07JUN1826100CE_2018-06-05.csv,10,4,6,-334.5,73193.25
BANKNIFTY07JUN1826100PE_2018-06-05.csv,9,5,4,672.0,41510.25
BANKNIFTY07JUN1826200CE_2018-06-05.csv,8,1,7,-1343.25,45329.25
BANKNIFTY07JUN1826200PE_2018-06-05.csv,11,3,8,-641.25,64704.0
BANKNIFTY07JUN1826300CE_2018-06-05.csv,6,1,5,-713.25,25008.75
BANKNIFTY07JUN1826300PE_2018-06-05.csv,10,6,4,1312.5,78392.25
BANKNIFTY07JUN1826400CE_2018-06-05.csv,10,3,7,-180.0,31563.0
BANKNIFTY07JUN1826400PE_2018-06-05.csv,12,5,7,386.25,116360.25
BANKNIFTY07JUN1826500CE_2018-06-05.csv,8,2,6,-351.75,19838.25
BANKNIFTY07JUN1826600CE_2018-06-05.csv,12,5,7,24.0,22996.5
BANKNIFTY07JUN1826700CE_2018-06-05.csv,12,6,6,122.25,18014.25
BANKNIFTY07JUN1826800CE_2018-06-05.csv,13,3,10,-330.75,14253.75
BANKNIFTY07JUN1826900CE_2018-06-05.csv,13,4,9,-96.0,10990.5
BANKNIFTY07JUN1827000CE_2018-06-05.csv,12,5,7,13.5,7426.5
BANKNIFTY07JUN1825700PE_2018-06-06.csv,13,6,7,21.75,6468.75
BANKNIFTY07JUN1825800PE_2018-06-06.csv,12,2,10,-213.75,7956.75
BANKNIFTY07JUN1825900PE_2018-06-06.csv,12,3,9,-153.75,12671.25
BANKNIFTY07JUN1826000CE_2018-06-06.csv,10,4,6,-764.25,101372.25
BANKNIFTY07JUN1826000PE_2018-06-06.csv,7,2,5,-90.75,9939.75
BANKNIFTY07JUN1826100CE_2018-06-06.csv,7,4,3,741.0,57804.0
BANKNIFTY07JUN1826100PE_2018-06-06.csv,11,3,8,-342.0,24145.5
BANKNIFTY07JUN1826200CE_2018-06-06.csv,5,2,3,-171.0,27409.5
BANKNIFTY07JUN1826200PE_2018-06-06.csv,9,2,7,-694.5,28081.5
BANKNIFTY07JUN1826300CE_2018-06-06.csv,6,2,4,-258.0,25399.5
BANKNIFTY07JUN1826300PE_2018-06-06.csv,11,2,9,-952.5,49894.5
BANKNIFTY07JUN1826400CE_2018-06-06.csv,4,1,3,-155.25,11325.75
BANKNIFTY07JUN1826400PE_2018-06-06.csv,13,3,10,-1275.75,83288.25
BANKNIFTY07JUN1826500CE_2018-06-06.csv,6,1,5,-216.0,12025.5
BANKNIFTY07JUN1826500PE_2018-06-06.csv,13,2,11,-2710.5,101784.0
BANKNIFTY07JUN1826600CE_2018-06-06.csv,8,2,6,-65.25,12204.75
BANKNIFTY07JUN1826700CE_2018-06-06.csv,7,2,5,-68.25,6567.75
BANKNIFTY07JUN1826800CE_2018-06-06.csv,10,3,7,-87.0,6034.5
BANKNIFTY07JUN1826200CE_2018-06-07.csv,15,5,10,-2687.25,206126.25
BANKNIFTY07JUN1826300CE_2018-06-07.csv,10,4,6,-519.75,106316.25
BANKNIFTY07JUN1826300PE_2018-06-07.csv,30,14,16,21.75,1579.5
BANKNIFTY07JUN1826400CE_2018-06-07.csv,10,4,6,-699.0,74364.0
BANKNIFTY07JUN1826400PE_2018-06-07.csv,14,6,8,45.75,1767.0
BANKNIFTY07JUN1826500CE_2018-06-07.csv,9,5,4,337.5,46278.0
BANKNIFTY07JUN1826500PE_2018-06-07.csv,13,6,7,41.25,4817.25
BANKNIFTY07JUN1826600CE_2018-06-07.csv,12,7,5,473.25,31402.5
BANKNIFTY07JUN1826600PE_2018-06-07.csv,12,5,7,36.75,11711.25
BANKNIFTY07JUN1826700CE_2018-06-07.csv,14,9,5,252.75,20454.0
BANKNIFTY07JUN1826700PE_2018-06-07.csv,9,2,7,-637.5,20023.5
BANKNIFTY07JUN1826800CE_2018-06-07.csv,15,8,7,24.0,8648.25
BANKNIFTY07JUN1826800PE_2018-06-07.csv,10,1,9,-1198.5,40651.5
BANKNIFTY07JUN1826900CE_2018-06-07.csv,15,10,5,152.25,3553.5
BANKNIFTY07JUN1826900PE_2018-06-07.csv,13,3,10,-970.5,104236.5
BANKNIFTY07JUN1827000PE_2018-06-07.csv,16,6,10,-277.5,146550.0
BANKNIFTY14JUN1825600PE_2018-06-08.csv,13,7,6,125.25,10401.75
BANKNIFTY14JUN1825700PE_2018-06-08.csv,10,3,7,-108.75,10679.25
BANKNIFTY14JUN1825800PE_2018-06-08.csv,9,3,6,-135.75,13284.75
BANKNIFTY14JUN1825900PE_2018-06-08.csv,9,3,6,-264.75,18764.25
BANKNIFTY14JUN1826000PE_2018-06-08.csv,9,4,5,-45.0,22821.0
BANKNIFTY14JUN1826100PE_2018-06-08.csv,6,1,5,-417.0,21132.75
BANKNIFTY14JUN1826200CE_2018-06-08.csv,10,4,6,477.75,91731.75
BANKNIFTY14JUN1826200PE_2018-06-08.csv,6,1,5,-470.25,26925.75
BANKNIFTY14JUN1826300CE_2018-06-08.csv,7,4,3,1011.0,52020.0
BANKNIFTY14JUN1826300PE_2018-06-08.csv,5,2,3,8.25,26118.75
BANKNIFTY14JUN1826400CE_2018-06-08.csv,5,2,3,23.25,29157.0
BANKNIFTY14JUN1826400PE_2018-06-08.csv,6,2,4,-469.5,40155.0
BANKNIFTY14JUN1826500CE_2018-06-08.csv,5,3,2,362.25,22974.0
BANKNIFTY14JUN1826500PE_2018-06-08.csv,6,2,4,-593.25,49181.25
BANKNIFTY14JUN1826600CE_2018-06-08.csv,9,4,5,249.75,29568.75
BANKNIFTY14JUN1826600PE_2018-06-08.csv,9,3,6,-668.25,94275.75
BANKNIFTY14JUN1826700CE_2018-06-08.csv,7,3,4,33.75,17411.25
BANKNIFTY14JUN1826800CE_2018-06-08.csv,7,1,6,-231.75,12310.5
BANKNIFTY14JUN1826900CE_2018-06-08.csv,9,4,5,39.0,11472.0
BANKNIFTY14JUN1827000CE_2018-06-08.csv,8,3,5,28.5,7488.0
BANKNIFTY14JUN1827100CE_2018-06-08.csv,12,7,5,149.25,7287.75
BANKNIFTY14JUN1825800PE_2018-06-11.csv,17,10,7,151.5,8361.0
BANKNIFTY14JUN1825900PE_2018-06-11.csv,13,6,7,46.5,9052.5
BANKNIFTY14JUN1826000PE_2018-06-11.csv,11,4,7,28.5,10755.0
BANKNIFTY14JUN1826100PE_2018-06-11.csv,7,3,4,57.75,9066.75
BANKNIFTY14JUN1826200PE_2018-06-11.csv,8,2,6,-153.75,15249.75
BANKNIFTY14JUN1826300CE_2018-06-11.csv,7,3,4,-196.5,72696.0
BANKNIFTY14JUN1826300PE_2018-06-11.csv,6,2,4,-56.25,13602.75
BANKNIFTY14JUN1826400CE_2018-06-11.csv,9,5,4,854.25,72555.75
BANKNIFTY14JUN1826400PE_2018-06-11.csv,7,3,4,180.0,23781.0
BANKNIFTY14JUN1826500CE_2018-06-11.csv,6,2,4,-246.0,38482.5
BANKNIFTY14JUN1826500PE_2018-06-11.csv,7,2,5,-108.75,31515.75
BANKNIFTY14JUN1826600CE_2018-06-11.csv,6,3,3,132.0,27894.0
BANKNIFTY14JUN1826600PE_2018-06-11.csv,7,2,5,-213.75,39261.75
BANKNIFTY14JUN1826700CE_2018-06-11.csv,7,4,3,320.25,25640.25
BANKNIFTY14JUN1826700PE_2018-06-11.csv,11,3,8,-578.25,84527.25
BANKNIFTY14JUN1826800CE_2018-06-11.csv,6,3,3,-31.5,15537.0
BANKNIFTY14JUN1826800PE_2018-06-11.csv,8,3,5,327.75,82461.0
BANKNIFTY14JUN1826900CE_2018-06-11.csv,7,3,4,-73.5,13192.5
BANKNIFTY14JUN1827000CE_2018-06-11.csv,9,3,6,-158.25,11600.25
BANKNIFTY14JUN1827100CE_2018-06-11.csv,13,5,8,-76.5,11673.0
BANKNIFTY14JUN1826000PE_2018-06-12.csv,10,3,7,-7.5,7917.0
BANKNIFTY14JUN1826100PE_2018-06-12.csv,10,3,7,-43.5,11484.0
BANKNIFTY14JUN1826200PE_2018-06-12.csv,8,2,6,-186.0,14350.5
BANKNIFTY14JUN1826300CE_2018-06-12.csv,9,4,5,550.5,86703.0
BANKNIFTY14JUN1826300PE_2018-06-12.csv,11,3,8,-367.5,23929.5
BANKNIFTY14JUN1826400CE_2018-06-12.csv,8,3,5,111.0,61978.5
BANKNIFTY14JUN1826400PE_2018-06-12.csv,8,3,5,95.25,26118.75
BANKNIFTY14JUN1826500CE_2018-06-12.csv,6,4,2,887.25,35994.75
BANKNIFTY14JUN1826500PE_2018-06-12.csv,7,2,5,-75.75,31988.25
BANKNIFTY14JUN1826600CE_2018-06-12.csv,4,2,2,187.5,18198.75
BANKNIFTY14JUN1826600PE_2018-06-12.csv,7,1,6,-855.75,38063.25
BANKNIFTY14JUN1826700CE_2018-06-12.csv,8,5,3,502.5,23849.25
BANKNIFTY14JUN1826700PE_2018-06-12.csv,13,2,11,-1859.25,101328.75
BANKNIFTY14JUN1826800CE_2018-06-12.csv,5,3,2,183.0,9286.5
BANKNIFTY14JUN1826800PE_2018-06-12.csv,13,3,10,-1699.5,124150.5
BANKNIFTY14JUN1826900CE_2018-06-12.csv,7,4,3,187.5,8685.0
BANKNIFTY14JUN1827000CE_2018-06-12.csv,9,4,5,18.0,7006.5
BANKNIFTY14JUN1826200PE_2018-06-13.csv,13,5,8,-12.75,6259.5
BANKNIFTY14JUN1826300PE_2018-06-13.csv,10,1,9,-266.25,8202.75
BANKNIFTY14JUN1826400CE_2018-06-13.csv,9,3,6,-571.5,79974.0
BANKNIFTY14JUN1826400PE_2018-06-13.csv,10,3,7,-201.75,12245.25
BANKNIFTY14JUN1826500CE_2018-06-13.csv,11,6,5,638.25,78318.0
BANKNIFTY14JUN1826500PE_2018-06-13.csv,11,2,9,-477.0,21394.5
BANKNIFTY14JUN1826600CE_2018-06-13.csv,8,3,5,-241.5,38943.0
BANKNIFTY14JUN1826600PE_2018-06-13.csv,5,0,5,-538.5,14697.0
BANKNIFTY14JUN1826700CE_2018-06-13.csv,9,5,4,344.25,32671.5
BANKNIFTY14JUN1826700PE_2018-06-13.csv,6,1,5,-618.75,27968.25
BANKNIFTY14JUN1826800CE_2018-06-13.csv,6,4,2,295.5,14913.0
BANKNIFTY14JUN1826800PE_2018-06-13.csv,10,1,9,-1728.75,61230.75
BANKNIFTY14JUN1826900CE_2018-06-13.csv,13,6,7,147.75,18501.75
BANKNIFTY14JUN1826900PE_2018-06-13.csv,13,3,10,-1681.5,105308.25
BANKNIFTY14JUN1827000CE_2018-06-13.csv,10,4,6,-15.75,7874.25
BANKNIFTY14JUN1826200CE_2018-06-14.csv,11,5,6,491.25,111776.25
BANKNIFTY14JUN1826300CE_2018-06-14.csv,13,7,6,1449.75,97118.25
BANKNIFTY14JUN1826400CE_2018-06-14.csv,13,7,6,978.75,63168.75
BANKNIFTY14JUN1826400PE_2018-06-14.csv,14,5,9,-12.75,4659.0
BANKNIFTY14JUN1826500CE_2018-06-14.csv,10,5,5,385.5,26190.0
BANKNIFTY14JUN1826500PE_2018-06-14.csv,11,3,8,-315.0,14180.25
BANKNIFTY14JUN1826600CE_2018-06-14.csv,16,6,10,24.0,17271.75
BANKNIFTY14JUN1826600PE_2018-06-14.csv,8,3,5,116.25,22185.75
BANKNIFTY14JUN1826700CE_2018-06-14.csv,23,10,13,60.75,8842.5
BANKNIFTY14JUN1826700PE_2018-06-14.csv,7,2,5,-99.75,35198.25
BANKNIFTY14JUN1826800CE_2018-06-14.csv,19,7,12,-63.75,2551.5
BANKNIFTY14JUN1826800PE_2018-06-14.csv,7,2,5,-352.5,46744.5
BANKNIFTY21JUN1825900PE_2018-06-15.csv,9,6,3,242.25,8246.25
BANKNIFTY21JUN1826000PE_2018-06-15.csv,8,5,3,227.25,10692.75
BANKNIFTY21JUN1826100PE_2018-06-15.csv,10,6,4,333.75,19217.25
BANKNIFTY21JUN1826200PE_2018-06-15.csv,9,4,5,4.5,24466.5
BANKNIFTY21JUN1826300CE_2018-06-15.csv,8,2,6,-1335.0,65313.0
BANKNIFTY21JUN1826300PE_2018-06-15.csv,9,5,4,453.0,32467.5
BANKNIFTY21JUN1826400CE_2018-06-15.csv,7,2,5,-414.75,47660.25
BANKNIFTY21JUN1826400PE_2018-06-15.csv,9,4,5,278.25,47271.75
BANKNIFTY21JUN1826500CE_2018-06-15.csv,5,3,2,305.25,25865.25
BANKNIFTY21JUN1826500PE_2018-06-15.csv,6,3,3,290.25,37947.75
BANKNIFTY21JUN1826600CE_2018-06-15.csv,3,1,2,-6.75,11591.25
BANKNIFTY21JUN1826600PE_2018-06-15.csv,7,3,4,262.5,59464.5
BANKNIFTY21JUN1826700CE_2018-06-15.csv,8,2,6,-466.5,22146.0
BANKNIFTY21JUN1826700PE_2018-06-15.csv,6,3,3,294.0,62027.25
BANKNIFTY21JUN1826800CE_2018-06-15.csv,7,3,4,-20.25,13252.5
BANKNIFTY21JUN1826900CE_2018-06-15.csv,7,1,6,-192.0,8007.0
BANKNIFTY21JUN1827000CE_2018-06-15.csv,8,2,6,-158.25,6765.0
BANKNIFTY21JUN1825900PE_2018-06-18.csv,9,3,6,-60.0,7605.75
BANKNIFTY21JUN1826000PE_2018-06-18.csv,10,3,7,-132.75,12374.25
BANKNIFTY21JUN1826100PE_2018-06-18.csv,10,3,7,-238.5,17785.5
BANKNIFTY21JUN1826200CE_2018-06-18.csv,9,3,6,223.5,67465.5
BANKNIFTY21JUN1826200PE_2018-06-18.csv,10,5,5,222.75,27402.75
BANKNIFTY21JUN1826300CE_2018-06-18.csv,8,5,3,1050.0,45772.5
BANKNIFTY21JUN1826300PE_2018-06-18.csv,7,3,4,86.25,27341.25
BANKNIFTY21JUN1826400CE_2018-06-18.csv,8,6,2,1183.5,35311.5
BANKNIFTY21JUN1826400PE_2018-06-18.csv,10,3,7,-299.25,50853.75
BANKNIFTY21JUN1826500CE_2018-06-18.csv,8,5,3,573.0,23617.5
BANKNIFTY21JUN1826500PE_2018-06-18.csv,10,3,7,-263.25,70531.5
BANKNIFTY21JUN1826600CE_2018-06-18.csv,7,4,3,180.0,13479.0
BANKNIFTY21JUN1826600PE_2018-06-18.csv,7,2,5,-412.5,64324.5
BANKNIFTY21JUN1826700CE_2018-06-18.csv,8,4,4,83.25,10580.25
BANKNIFTY21JUN1826800CE_2018-06-18.csv,8,4,4,39.75,6174.75
BANKNIFTY21JUN1825800PE_2018-06-19.csv,13,4,9,-33.0,9340.5
BANKNIFTY21JUN1825900PE_2018-06-19.csv,8,5,3,170.25,8217.75
BANKNIFTY21JUN1826000CE_2018-06-19.csv,10,4,6,327.0,97971.0
BANKNIFTY21JUN1826000PE_2018-06-19.csv,7,3,4,-20.25,12372.0
BANKNIFTY21JUN1826100CE_2018-06-19.csv,10,3,7,-325.5,74386.5
BANKNIFTY21JUN1826100PE_2018-06-19.csv,8,6,2,600.75,20443.5
BANKNIFTY21JUN1826200CE_2018-06-19.csv,8,2,6,-330.75,41211.75
BANKNIFTY21JUN1826200PE_2018-06-19.csv,6,5,1,776.25,20255.25
BANKNIFTY21JUN1826300CE_2018-06-19.csv,6,0,6,-736.5,21238.5
BANKNIFTY21JUN1826300PE_2018-06-19.csv,6,3,3,186.75,30188.25
BANKNIFTY21JUN1826400CE_2018-06-19.csv,9,3,6,-54.75,21135.75
BANKNIFTY21JUN1826400PE_2018-06-19.csv,7,4,3,698.25,46797.0
BANKNIFTY21JUN1826500CE_2018-06-19.csv,9,2,7,-167.25,12977.25
BANKNIFTY21JUN1826500PE_2018-06-19.csv,5,3,2,969.0,46762.5
BANKNIFTY21JUN1826600CE_2018-06-19.csv,12,4,8,-69.0,10470.0
BANKNIFTY21JUN1826700CE_2018-06-19.csv,9,4,5,24.75,4578.75
BANKNIFTY21JUN1826000PE_2018-06-20.csv,11,1,10,-74.25,2827.5
BANKNIFTY21JUN1826100CE_2018-06-20.csv,4,3,1,1427.25,47902.5
BANKNIFTY21JUN1826100PE_2018-06-20.csv,12,1,11,-171.75,4344.75
BANKNIFTY21JUN1826200CE_2018-06-20.csv,5,4,1,1731.0,47375.25
BANKNIFTY21JUN1826200PE_2018-06-20.csv,9,1,8,-267.0,7737.75
BANKNIFTY21JUN1826300CE_2018-06-20.csv,7,3,4,-131.25,40032.75
BANKNIFTY21JUN1826300PE_2018-06-20.csv,8,2,6,-217.5,9937.5
BANKNIFTY21JUN1826400CE_2018-06-20.csv,8,3,5,-45.0,31443.0
BANKNIFTY21JUN1826400PE_2018-06-20.csv,8,1,7,-396.0,16488.0
BANKNIFTY21JUN1826500CE_2018-06-20.csv,7,2,5,-192.0,19474.5
BANKNIFTY21JUN1826500PE_2018-06-20.csv,7,1,6,-465.75,20457.75
BANKNIFTY21JUN1826600CE_2018-06-20.csv,5,2,3,-79.5,6018.0
BANKNIFTY21JUN1826600PE_2018-06-20.csv,9,1,8,-1283.25,47990.25
BANKNIFTY21JUN1826700CE_2018-06-20.csv,11,3,8,-137.25,8214.75
BANKNIFTY21JUN1826700PE_2018-06-20.csv,12,1,11,-2307.75,87335.25
BANKNIFTY21JUN1826200CE_2018-06-21.csv,14,4,10,-1351.5,147441.75
BANKNIFTY21JUN1826300CE_2018-06-21.csv,8,3,5,76.5,62928.75
BANKNIFTY21JUN1826400CE_2018-06-21.csv,10,4,6,-123.75,45677.25
BANKNIFTY21JUN1826500CE_2018-06-21.csv,10,2,8,-1217.25,21491.25
BANKNIFTY21JUN1826500PE_2018-06-21.csv,17,8,9,57.75,7436.25
BANKNIFTY21JUN1826600CE_2018-06-21.csv,11,6,5,-92.25,11932.5
BANKNIFTY21JUN1826600PE_2018-06-21.csv,13,7,6,138.75,21383.25
BANKNIFTY21JUN1826700CE_2018-06-21.csv,14,7,7,-60.75,4960.5
BANKNIFTY21JUN1826700PE_2018-06-21.csv,10,2,8,-633.75,36144.75
BANKNIFTY21JUN1826800PE_2018-06-21.csv,12,5,7,365.25,77666.25
BANKNIFTY21JUN1826900PE_2018-06-21.csv,13,5,8,-279.0,126987.75
BANKNIFTY28JUN1825800PE_2018-06-22.csv,12,1,11,-246.0,7017.0
BANKNIFTY28JUN1825900PE_2018-06-22.csv,8,1,7,-200.25,7442.25
BANKNIFTY28JUN1826000PE_2018-06-22.csv,10,2,8,-225.75,11295.75
BANKNIFTY28JUN1826100PE_2018-06-22.csv,10,0,10,-623.25,15299.25
BANKNIFTY28JUN1826200CE_2018-06-22.csv,11,7,4,3636.75,127105.5
BANKNIFTY28JUN1826200PE_2018-06-22.csv,7,1,6,-291.0,14082.0
BANKNIFTY28JUN1826300CE_2018-06-22.csv,6,3,3,468.0,56276.25
BANKNIFTY28JUN1826300PE_2018-06-22.csv,6,1,5,-501.0,19849.5
BANKNIFTY28JUN1826400CE_2018-06-22.csv,9,5,4,1236.0,51966.0
BANKNIFTY28JUN1826400PE_2018-06-22.csv,7,1,6,-815.25,24282.75
BANKNIFTY28JUN1826500CE_2018-06-22.csv,5,2,3,236.25,27935.25
BANKNIFTY28JUN1826500PE_2018-06-22.csv,9,3,6,-291.75,51537.75
BANKNIFTY28JUN1826600CE_2018-06-22.csv,9,6,3,1079.25,38415.0
BANKNIFTY28JUN1826600PE_2018-06-22.csv,5,1,4,-601.5,38115.0
BANKNIFTY28JUN1826700CE_2018-06-22.csv,10,6,4,579.0,22597.5
BANKNIFTY28JUN1826700PE_2018-06-22.csv,8,0,8,-2610.0,63964.5
BANKNIFTY28JUN1826800CE_2018-06-22.csv,9,6,3,446.25,16478.25
BANKNIFTY28JUN1826900CE_2018-06-22.csv,10,6,4,318.75,14254.5
BANKNIFTY28JUN1826000PE_2018-06-25.csv,9,5,4,72.0,4903.5
BANKNIFTY28JUN1826100PE_2018-06-25.csv,11,5,6,55.5,7813.5
BANKNIFTY28JUN1826200PE_2018-06-25.csv,8,6,2,234.0,7960.5
BANKNIFTY28JUN1826300PE_2018-06-25.csv,8,5,3,220.5,10075.5
BANKNIFTY28JUN1826400CE_2018-06-25.csv,16,7,9,894.0,167481.0
BANKNIFTY28JUN1826400PE_2018-06-25.csv,9,4,5,145.5,15829.5
BANKNIFTY28JUN1826500CE_2018-06-25.csv,11,2,9,-1377.75,91074.75
BANKNIFTY28JUN1826500PE_2018-06-25.csv,11,6,5,405.75,25820.25
BANKNIFTY28JUN1826600CE_2018-06-25.csv,13,2,11,-1614.0,80721.0
BANKNIFTY28JUN1826600PE_2018-06-25.csv,6,4,2,530.25,19772.25
BANKNIFTY28JUN1826700CE_2018-06-25.csv,8,3,5,-220.5,35094.0
BANKNIFTY28JUN1826700PE_2018-06-25.csv,10,5,5,718.5,47319.0
BANKNIFTY28JUN1826800CE_2018-06-25.csv,5,1,4,-320.25,17922.75
BANKNIFTY28JUN1826800PE_2018-06-25.csv,9,4,5,379.5,57330.0
BANKNIFTY28JUN1826900CE_2018-06-25.csv,8,1,7,-503.25,19674.75
BANKNIFTY28JUN1826900PE_2018-06-25.csv,13,8,5,2035.5,114222.0
BANKNIFTY28JUN1827000CE_2018-06-25.csv,13,3,10,-398.25,21256.5
BANKNIFTY28JUN1827000PE_2018-06-25.csv,9,4,5,544.5,98637.0
BANKNIFTY28JUN1827100CE_2018-06-25.csv,9,3,6,-83.25,9801.75
BANKNIFTY28JUN1827200CE_2018-06-25.csv,14,4,10,-136.5,10485.75
BANKNIFTY28JUN1826100PE_2018-06-26.csv,10,4,6,-21.0,5936.25
BANKNIFTY28JUN1826200PE_2018-06-26.csv,11,5,6,74.25,8570.25
BANKNIFTY28JUN1826300CE_2018-06-26.csv,13,6,7,381.0,135586.5
BANKNIFTY28JUN1826300PE_2018-06-26.csv,11,4,7,-69.0,14575.5
BANKNIFTY28JUN1826400CE_2018-06-26.csv,9,5,4,893.25,74973.0
BANKNIFTY28JUN1826400PE_2018-06-26.csv,10,5,5,239.25,20130.0
BANKNIFTY28JUN1826500CE_2018-06-26.csv,12,7,5,759.0,72150.0
BANKNIFTY28JUN1826500PE_2018-06-26.csv,9,4,5,154.5,24753.0
BANKNIFTY28JUN1826600CE_2018-06-26.csv,10,5,5,333.75,41928.75
BANKNIFTY28JUN1826600PE_2018-06-26.csv,8,3,5,-324.75,30918.0
BANKNIFTY28JUN1826700CE_2018-06-26.csv,9,4,5,-42.0,25192.5
BANKNIFTY28JUN1826700PE_2018-06-26.csv,11,4,7,-161.25,58535.25
BANKNIFTY28JUN1826800CE_2018-06-26.csv,9,3,6,-243.75,17592.75
BANKNIFTY28JUN1826800PE_2018-06-26.csv,14,5,9,-225.75,108660.0
BANKNIFTY28JUN1826900CE_2018-06-26.csv,7,3,4,-59.25,8685.75
BANKNIFTY28JUN1826900PE_2018-06-26.csv,16,5,11,-1248.75,159489.75
BANKNIFTY28JUN1827000CE_2018-06-26.csv,7,3,4,3.75,6174.0
BANKNIFTY28JUN1826200CE_2018-06-27.csv,11,3,8,-908.25,92990.25
BANKNIFTY28JUN1826200PE_2018-06-27.csv,16,6,10,-162.0,10955.25
BANKNIFTY28JUN1826300CE_2018-06-27.csv,10,1,9,-1404.75,68411.25
BANKNIFTY28JUN1826300PE_2018-06-27.csv,12,2,10,-581.25,15743.25
BANKNIFTY28JUN1826400CE_2018-06-27.csv,5,2,3,-254.25,23174.25
BANKNIFTY28JUN1826400PE_2018-06-27.csv,10,3,7,-546.0,20807.25
BANKNIFTY28JUN1826500CE_2018-06-27.csv,5,1,4,-422.25,13307.25
BANKNIFTY28JUN1826500PE_2018-06-27.csv,11,5,6,-15.75,39203.25
BANKNIFTY28JUN1826600CE_2018-06-27.csv,8,3,5,-174.0,10806.0
BANKNIFTY28JUN1826600PE_2018-06-27.csv,11,4,7,-447.0,64716.0
BANKNIFTY28JUN1826700CE_2018-06-27.csv,8,5,3,33.75,6357.75
BANKNIFTY28JUN1826700PE_2018-06-27.csv,10,4,6,-288.75,79631.25
BANKNIFTY28JUN1826800CE_2018-06-27.csv,11,3,8,-60.75,6426.0
BANKNIFTY28JUN1826800PE_2018-06-27.csv,14,7,7,1167.75,152288.25
BANKNIFTY28JUN1826900CE_2018-06-27.csv,15,8,7,3.75,4743.75
BANKNIFTY28JUN1826000CE_2018-06-28.csv,11,3,8,-888.0,122080.5
BANKNIFTY28JUN1826100CE_2018-06-28.csv,12,5,7,215.25,92352.75
BANKNIFTY28JUN1826200CE_2018-06-28.csv,12,3,9,-864.75,52593.75
BANKNIFTY28JUN1826200PE_2018-06-28.csv,12,5,7,-199.5,5886.0
BANKNIFTY28JUN1826300CE_2018-06-28.csv,10,2,8,-729.0,27654.0
BANKNIFTY28JUN1826300PE_2018-06-28.csv,10,4,6,-454.5,10719.75
BANKNIFTY28JUN1826400CE_2018-06-28.csv,14,4,10,-726.75,17079.0
BANKNIFTY28JUN1826400PE_2018-06-28.csv,10,3,7,-560.25,31436.25
BANKNIFTY28JUN1826500CE_2018-06-28.csv,16,4,12,-369.0,7527.75
BANKNIFTY28JUN1826500PE_2018-06-28.csv,6,1,5,-889.5,28696.5
BANKNIFTY28JUN1826600CE_2018-06-28.csv,22,6,16,-157.5,4270.5
BANKNIFTY28JUN1826600PE_2018-06-28.csv,12,3,9,-1668.0,95220.0
BANKNIFTY28JUN1826700PE_2018-06-28.csv,12,4,8,-873.75,121265.25
BANKNIFTY05JUL1825700PE_2018-06-29.csv,9,5,4,90.75,5211.75
BANKNIFTY05JUL1825800PE_2018-06-29.csv,9,1,8,-189.0,7479.0
BANKNIFTY05JUL1825900PE_2018-06-29.csv,7,3,4,87.75,7806.75
BANKNIFTY05JUL1826000PE_2018-06-29.csv,7,3,4,51.75,11115.75
BANKNIFTY05JUL1826100PE_2018-06-29.csv,6,2,4,-158.25,12887.25
BANKNIFTY05JUL1826200CE_2018-06-29.csv,6,3,3,614.25,56630.25
BANKNIFTY05JUL1826200PE_2018-06-29.csv,7,3,4,81.0,22644.0
BANKNIFTY05JUL1826300CE_2018-06-29.csv,5,3,2,538.5,37367.25
BANKNIFTY05JUL1826300PE_2018-06-29.csv,7,3,4,133.5,28788.0
BANKNIFTY05JUL1826400CE_2018-06-29.csv,7,2,5,-497.25,41462.25
BANKNIFTY05JUL1826400PE_2018-06-29.csv,9,5,4,932.25,49119.75
BANKNIFTY05JUL1826500CE_2018-06-29.csv,6,3,3,108.0,23265.0
BANKNIFTY05JUL1826500PE_2018-06-29.csv,10,5,5,660.75,70055.25
BANKNIFTY05JUL1826600CE_2018-06-29.csv,7,2,5,-318.0,21646.5
BANKNIFTY05JUL1826600PE_2018-06-29.csv,8,2,6,-430.5,76126.5
BANKNIFTY05JUL1826700CE_2018-06-29.csv,6,1,5,-363.0,13599.0
BANKNIFTY05JUL1826800CE_2018-06-29.csv,6,2,4,-198.0,8979.75
BANKNIFTY05JUL1826900CE_2018-06-29.csv,7,0,7,-342.0,7134.0
BANKNIFTY05JUL1825700PE_2018-07-02.csv,11,5,6,25.5,9426.0
BANKNIFTY05JUL1825800PE_2018-07-02.csv,8,4,4,199.5,9585.0
BANKNIFTY05JUL1825900PE_2018-07-02.csv,11,4,7,-99.0,17241.0
BANKNIFTY05JUL1826000CE_2018-07-02.csv,14,4,10,-1247.25,124598.25
BANKNIFTY05JUL1826000PE_2018-07-02.csv,12,5,7,168.0,28114.5
BANKNIFTY05JUL1826100CE_2018-07-02.csv,10,4,6,-278.25,66955.5
BANKNIFTY05JUL1826100PE_2018-07-02.csv,9,4,5,243.0,31624.5
BANKNIFTY05JUL1826200CE_2018-07-02.csv,10,3,7,-416.25,50817.75
BANKNIFTY05JUL1826200PE_2018-07-02.csv,8,3,5,-63.75,39135.75
BANKNIFTY05JUL1826300CE_2018-07-02.csv,10,4,6,-165.0,34099.5
BANKNIFTY05JUL1826300PE_2018-07-02.csv,8,3,5,-149.25,52608.75
BANKNIFTY05JUL1826400PE_2018-07-02.csv,11,3,8,-566.25,90639.75
BANKNIFTY05JUL1826500CE_2018-07-02.csv,11,6,5,42.75,18318.75
BANKNIFTY05JUL1826500PE_2018-07-02.csv,10,3,7,-243.0,107436.0
BANKNIFTY05JUL1826600CE_2018-07-02.csv,7,5,2,225.75,7565.25
BANKNIFTY05JUL1826700CE_2018-07-02.csv,9,4,5,-32.25,6668.25
BANKNIFTY05JUL1826800CE_2018-07-02.csv,11,6,5,69.0,5014.5
BANKNIFTY05JUL1825800PE_2018-07-03.csv,15,7,8,75.75,8657.25
BANKNIFTY05JUL1825900PE_2018-07-03.csv,8,1,7,-155.25,6854.25
BANKNIFTY05JUL1826000CE_2018-07-03.csv,11,4,7,-192.0,102495.0
BANKNIFTY05JUL1826000PE_2018-07-03.csv,7,1,6,-210.75,10083.75
BANKNIFTY05JUL1826100CE_2018-07-03.csv,13,4,9,-519.75,96349.5
BANKNIFTY05JUL1826100PE_2018-07-03.csv,4,0,4,-260.25,7748.25
BANKNIFTY05JUL1826200CE_2018-07-03.csv,10,4,6,123.0,52717.5
BANKNIFTY05JUL1826200PE_2018-07-03.csv,9,3,6,-9.0,29698.5
BANKNIFTY05JUL1826300CE_2018-07-03.csv,9,1,8,-849.0,32751.0
BANKNIFTY05JUL1826300PE_2018-07-03.csv,9,2,7,-483.75,41858.25
BANKNIFTY05JUL1826400CE_2018-07-03.csv,10,1,9,-611.25,26638.5
BANKNIFTY05JUL1826400PE_2018-07-03.csv,12,5,7,168.0,75572.25
BANKNIFTY05JUL1826500CE_2018-07-03.csv,15,6,9,-29.25,24572.25
BANKNIFTY05JUL1826500PE_2018-07-03.csv,14,6,8,720.0,115123.5
BANKNIFTY05JUL1826600CE_2018-07-03.csv,16,5,11,-97.5,17509.5
BANKNIFTY05JUL1826700CE_2018-07-03.csv,12,4,8,-47.25,8631.75
BANKNIFTY05JUL1825900PE_2018-07-04.csv,11,3,8,-62.25,5736.75
BANKNIFTY05JUL1826000CE_2018-07-04.csv,9,4,5,1375.5,78468.75
BANKNIFTY05JUL1826000PE_2018-07-04.csv,15,3,12,-291.75,12255.75
BANKNIFTY05JUL1826100CE_2018-07-04.csv,9,5,4,1158.75,53407.5
BANKNIFTY05JUL1826100PE_2018-07-04.csv,10,1,9,-486.75,16739.25
BANKNIFTY05JUL1826200CE_2018-07-04.csv,8,6,2,1621.5,38536.5
BANKNIFTY05JUL1826200PE_2018-07-04.csv,9,2,7,-449.25,23661.75
BANKNIFTY05JUL1826300CE_2018-07-04.csv,7,2,5,-111.0,17584.5
BANKNIFTY05JUL1826300PE_2018-07-04.csv,7,0,7,-963.0,30240.0
BANKNIFTY05JUL1826400CE_2018-07-04.csv,10,5,5,255.0,18898.5
BANKNIFTY05JUL1826400PE_2018-07-04.csv,9,2,7,-1242.0,49761.0
BANKNIFTY05JUL1826500CE_2018-07-04.csv,13,5,8,-36.75,10766.25
BANKNIFTY05JUL1826500PE_2018-07-04.csv,8,1,7,-1805.25,51456.75
BANKNIFTY05JUL1826600CE_2018-07-04.csv,12,5,7,-28.5,5610.0
BANKNIFTY05JUL1826200CE_2018-07-05.csv,11,4,7,-699.75,107310.0
BANKNIFTY05JUL1826300CE_2018-07-05.csv,11,5,6,237.0,75763.5
BANKNIFTY05JUL1826400CE_2018-07-05.csv,10,5,5,368.25,41377.5
BANKNIFTY05JUL1826400PE_2018-07-05.csv,17,7,10,6.0,5963.25
BANKNIFTY05JUL1826500CE_2018-07-05.csv,13,7,6,506.25,20852.25
BANKNIFTY05JUL1826500PE_2018-07-05.csv,13,4,9,-307.5,16510.5
BANKNIFTY05JUL1826600CE_2018-07-05.csv,16,9,7,6.0,9335.25
BANKNIFTY05JUL1826600PE_2018-07-05.csv,10,5,5,255.75,27597.75
BANKNIFTY05JUL1826700PE_2018-07-05.csv,13,5,8,-119.25,64857.75
BANKNIFTY05JUL1826800PE_2018-07-05.csv,16,3,13,-1938.0,125517.0
BANKNIFTY12JUL1825900PE_2018-07-06.csv,9,4,5,22.5,4743.0
BANKNIFTY12JUL1826000PE_2018-07-06.csv,7,4,3,96.75,5537.25
BANKNIFTY12JUL1826100PE_2018-07-06.csv,5,1,4,-105.75,6015.0
BANKNIFTY12JUL1826200PE_2018-07-06.csv,7,1,6,-272.25,11595.75
BANKNIFTY12JUL1826300CE_2018-07-06.csv,7,1,6,-1192.5,67686.0
BANKNIFTY12JUL1826300PE_2018-07-06.csv,5,2,3,-3.75,11414.25
BANKNIFTY12JUL1826400CE_2018-07-06.csv,4,1,3,-189.75,31773.0
BANKNIFTY12JUL1826400PE_2018-07-06.csv,5,2,3,3.0,16084.5
BANKNIFTY12JUL1826500CE_2018-07-06.csv,6,2,4,-298.5,34754.25
BANKNIFTY12JUL1826500PE_2018-07-06.csv,7,1,6,-589.5,32102.25
BANKNIFTY12JUL1826600CE_2018-07-06.csv,7,1,6,-623.25,29830.5
BANKNIFTY12JUL1826600PE_2018-07-06.csv,6,3,3,369.75,34782.75
BANKNIFTY12JUL1826700CE_2018-07-06.csv,8,2,6,-213.0,23650.5
BANKNIFTY12JUL1826700PE_2018-07-06.csv,6,3,3,411.0,46492.5
BANKNIFTY12JUL1826800CE_2018-07-06.csv,5,1,4,-171.0,9012.0
BANKNIFTY12JUL1826900CE_2018-07-06.csv,9,3,6,-97.5,11600.25
BANKNIFTY12JUL1827000CE_2018-07-06.csv,6,1,5,-132.75,5184.75
BANKNIFTY12JUL1826200PE_2018-07-09.csv,7,2,5,-26.25,3480.75
BANKNIFTY12JUL1826300PE_2018-07-09.csv,5,3,2,72.75,3972.75
BANKNIFTY12JUL1826400CE_2018-07-09.csv,4,2,2,384.0,43934.25
BANKNIFTY12JUL1826400PE_2018-07-09.csv,6,0,6,-188.25,6774.0
BANKNIFTY12JUL1826500CE_2018-07-09.csv,1,1,0,435.75,10964.25
BANKNIFTY12JUL1826500PE_2018-07-09.csv,7,3,4,50.25,12867.0
BANKNIFTY12JUL1826600CE_2018-07-09.csv,7,3,4,215.25,40440.75
BANKNIFTY12JUL1826600PE_2018-07-09.csv,5,2,3,-73.5,14812.5
BANKNIFTY12JUL1826700CE_2018-07-09.csv,1,1,0,188.25,5615.25
BANKNIFTY12JUL1826700PE_2018-07-09.csv,5,0,5,-593.25,21288.75
BANKNIFTY12JUL1826800CE_2018-07-09.csv,5,1,4,-232.5,13649.25
BANKNIFTY12JUL1826800PE_2018-07-09.csv,3,0,3,-519.75,19487.25
BANKNIFTY12JUL1826900CE_2018-07-09.csv,6,2,4,-68.25,10269.75
BANKNIFTY12JUL1826900PE_2018-07-09.csv,4,0,4,-998.25,34332.75
BANKNIFTY12JUL1827000CE_2018-07-09.csv,7,3,4,39.0,7050.0
BANKNIFTY12JUL1826500CE_2018-07-10.csv,4,1,3,-245.25,51595.5
BANKNIFTY12JUL1826500PE_2018-07-10.csv,4,1,3,-65.25,2198.25
BANKNIFTY12JUL1826600CE_2018-07-10.csv,4,0,4,-964.5,38915.25
BANKNIFTY12JUL1826600PE_2018-07-10.csv,4,1,3,-116.25,3681.75
BANKNIFTY12JUL1826700CE_2018-07-10.csv,6,2,4,-21.75,40970.25
BANKNIFTY12JUL1826700PE_2018-07-10.csv,6,1,5,-243.0,8314.5
BANKNIFTY12JUL1826800CE_2018-07-10.csv,2,0,2,-270.75,11159.25
BANKNIFTY12JUL1826800PE_2018-07-10.csv,3,1,2,-153.75,6450.75
BANKNIFTY12JUL1826900CE_2018-07-10.csv,4,1,3,-158.25,10902.75
BANKNIFTY12JUL1826900PE_2018-07-10.csv,3,1,2,-69.0,11233.5
BANKNIFTY12JUL1827000CE_2018-07-10.csv,6,2,4,-45.0,10165.5
BANKNIFTY12JUL1827000PE_2018-07-10.csv,4,1,3,-421.5,21217.5
BANKNIFTY12JUL1827100CE_2018-07-10.csv,5,0,5,-172.5,4686.0
BANKNIFTY12JUL1827100PE_2018-07-10.csv,10,2,8,-1319.25,80979.75
BANKNIFTY12JUL1826500CE_2018-07-11.csv,11,2,9,-1623.0,101377.5
BANKNIFTY12JUL1826600CE_2018-07-11.csv,9,1,8,-1144.5,58947.0
BANKNIFTY12JUL1826600PE_2018-07-11.csv,10,4,6,-49.5,7653.0
BANKNIFTY12JUL1826700CE_2018-07-11.csv,8,2,6,-339.0,36309.0
BANKNIFTY12JUL1826700PE_2018-07-11.csv,8,4,4,30.0,10945.5
BANKNIFTY12JUL1826800CE_2018-07-11.csv,6,2,4,-201.75,17711.25
BANKNIFTY12JUL1826800PE_2018-07-11.csv,9,5,4,335.25,24110.25
BANKNIFTY12JUL1826900CE_2018-07-11.csv,11,3,8,-126.75,15023.25
BANKNIFTY12JUL1826900PE_2018-07-11.csv,10,5,5,282.75,42815.25
BANKNIFTY12JUL1827000CE_2018-07-11.csv,13,1,12,-276.0,9595.5
BANKNIFTY12JUL1827000PE_2018-07-11.csv,8,3,5,-247.5,53244.0
BANKNIFTY12JUL1827100PE_2018-07-11.csv,6,2,4,-334.5,57232.5
BANKNIFTY12JUL1826600CE_2018-07-12.csv,8,3,5,22.5,115429.5
BANKNIFTY12JUL1826700CE_2018-07-12.csv,13,6,7,984.75,144879.75
BANKNIFTY12JUL1826800CE_2018-07-12.csv,9,3,6,-359.25,73485.75
BANKNIFTY12JUL1826800PE_2018-07-12.csv,31,19,12,15.0,983.25
BANKNIFTY12JUL1826900CE_2018-07-12.csv,10,4,6,124.5,49527.0
BANKNIFTY12JUL1826900PE_2018-07-12.csv,23,9,14,-39.75,2077.5
BANKNIFTY12JUL1827000CE_2018-07-12.csv,7,4,3,403.5,20634.0
BANKNIFTY12JUL1827000PE_2018-07-12.csv,10,5,5,105.0,4440.75
BANKNIFTY12JUL1827100CE_2018-07-12.csv,14,7,7,-10.5,13394.25
BANKNIFTY12JUL1827100PE_2018-07-12.csv,10,6,4,258.75,17508.75
BANKNIFTY12JUL1827200CE_2018-07-12.csv,15,10,5,162.75,4260.0
BANKNIFTY12JUL1827200PE_2018-07-12.csv,9,3,6,-257.25,35333.25
BANKNIFTY12JUL1827300PE_2018-07-12.csv,11,5,6,441.0,76517.25
BANKNIFTY19JUL1826500PE_2018-07-13.csv,14,3,11,-224.25,13083.75
BANKNIFTY19JUL1826600PE_2018-07-13.csv,11,4,7,-37.5,14466.0
BANKNIFTY19JUL1826700PE_2018-07-13.csv,10,3,7,-231.0,18354.0
BANKNIFTY19JUL1826800CE_2018-07-13.csv,7,3,4,301.5,61109.25
BANKNIFTY19JUL1826800PE_2018-07-13.csv,8,4,4,245.25,20330.25
BANKNIFTY19JUL1826900CE_2018-07-13.csv,8,2,6,-621.75,53294.25
BANKNIFTY19JUL1826900PE_2018-07-13.csv,9,3,6,-169.5,32841.0
BANKNIFTY19JUL1827000CE_2018-07-13.csv,6,3,3,312.0,30018.75
BANKNIFTY19JUL1827000PE_2018-07-13.csv,7,1,6,-670.5,34861.5
BANKNIFTY19JUL1827100CE_2018-07-13.csv,6,2,4,-87.75,19860.75
BANKNIFTY19JUL1827100PE_2018-07-13.csv,10,3,7,-469.5,68624.25
BANKNIFTY19JUL1827200CE_2018-07-13.csv,11,6,5,357.75,28089.0
BANKNIFTY19JUL1827200PE_2018-07-13.csv,8,3,5,144.0,69121.5
BANKNIFTY19JUL1827300CE_2018-07-13.csv,9,3,6,-52.5,15880.5
BANKNIFTY19JUL1827400CE_2018-07-13.csv,8,3,5,3.75,8631.75
BANKNIFTY19JUL1827500CE_2018-07-13.csv,6,0,6,-157.5,4899.75
BANKNIFTY19JUL1826500PE_2018-07-16.csv,11,5,6,76.5,11236.5
BANKNIFTY19JUL1826600CE_2018-07-16.csv,9,2,7,-859.5,69769.5
BANKNIFTY19JUL1826600PE_2018-07-16.csv,11,5,6,214.5,17470.5
BANKNIFTY19JUL1826700CE_2018-07-16.csv,10,2,8,-855.75,56933.25
BANKNIFTY19JUL1826700PE_2018-07-16.csv,8,5,3,366.75,19799.25
BANKNIFTY19JUL1826800CE_2018-07-16.csv,9,2,7,-394.5,35205.0
BANKNIFTY19JUL1826800PE_2018-07-16.csv,9,5,4,498.75,34556.25
BANKNIFTY19JUL1826900CE_2018-07-16.csv,9,2,7,-189.0,23547.0
BANKNIFTY19JUL1826900PE_2018-07-16.csv,10,6,4,1068.0,53236.5
BANKNIFTY19JUL1827000CE_2018-07-16.csv,8,1,7,-358.5,15016.5
BANKNIFTY19JUL1827000PE_2018-07-16.csv,9,6,3,1855.5,70630.5
BANKNIFTY19JUL1827100CE_2018-07-16.csv,10,2,8,-246.75,11868.75
BANKNIFTY19JUL1827100PE_2018-07-16.csv,9,6,3,2199.0,86103.0
BANKNIFTY19JUL1827200CE_2018-07-16.csv,9,3,6,-32.25,6621.75
BANKNIFTY19JUL1827300CE_2018-07-16.csv,11,2,9,-102.75,5455.5
BANKNIFTY19JUL1826400PE_2018-07-17.csv,10,5,5,32.25,3807.0
BANKNIFTY19JUL1826500CE_2018-07-17.csv,4,3,1,1596.75,54558.75
BANKNIFTY19JUL1826500PE_2018-07-17.csv,7,2,5,-61.5,3717.0
BANKNIFTY19JUL1826600CE_2018-07-17.csv,7,4,3,1920.75,74329.5
BANKNIFTY19JUL1826600PE_2018-07-17.csv,10,4,6,52.5,9322.5
BANKNIFTY19JUL1826700CE_2018-07-17.csv,6,4,2,1696.5,43684.5
BANKNIFTY19JUL1826700PE_2018-07-17.csv,9,3,6,56.25,12491.25
BANKNIFTY19JUL1826800CE_2018-07-17.csv,3,2,1,654.0,21207.75
BANKNIFTY19JUL1826800PE_2018-07-17.csv,5,2,3,-45.75,9471.75
BANKNIFTY19JUL1826900CE_2018-07-17.csv,7,5,2,798.75,25620.0
BANKNIFTY19JUL1826900PE_2018-07-17.csv,10,3,7,-458.25,33014.25
BANKNIFTY19JUL1827000CE_2018-07-17.csv,6,3,3,326.25,12717.75
BANKNIFTY19JUL1827000PE_2018-07-17.csv,10,2,8,-724.5,53851.5
BANKNIFTY19JUL1827100CE_2018-07-17.csv,8,5,3,346.5,12042.75
BANKNIFTY19JUL1827100PE_2018-07-17.csv,8,2,6,-1046.25,51851.25
BANKNIFTY19JUL1826600PE_2018-07-18.csv,11,4,7,-121.5,3454.5
BANKNIFTY19JUL1826700CE_2018-07-18.csv,7,2,5,-695.25,74804.25
BANKNIFTY19JUL1826700PE_2018-07-18.csv,11,7,4,135.0,5670.0
BANKNIFTY19JUL1826800CE_2018-07-18.csv,11,3,8,-1542.75,88943.25
BANKNIFTY19JUL1826800PE_2018-07-18.csv,12,6,6,-20.25,9207.75
BANKNIFTY19JUL1826900CE_2018-07-18.csv,8,0,8,-2357.25,54609.75
BANKNIFTY19JUL1826900PE_2018-07-18.csv,10,7,3,455.25,11201.25
BANKNIFTY19JUL1827000CE_2018-07-18.csv,8,1,7,-1346.25,37991.25
BANKNIFTY19JUL1827000PE_2018-07-18.csv,9,5,4,336.75,18276.75
BANKNIFTY19JUL1827100CE_2018-07-18.csv,4,0,4,-315.75,10452.75
BANKNIFTY19JUL1827100PE_2018-07-18.csv,7,2,5,-808.5,23563.5
BANKNIFTY19JUL1827200CE_2018-07-18.csv,9,2,7,-273.75,16274.25
BANKNIFTY19JUL1827200PE_2018-07-18.csv,11,5,6,-143.25,64407.75
BANKNIFTY19JUL1827300CE_2018-07-18.csv,7,0,7,-337.5,7369.5
BANKNIFTY19JUL1827300PE_2018-07-18.csv,15,6,9,-285.75,105695.25
BANKNIFTY19JUL1827400CE_2018-07-18.csv,6,0,6,-236.25,4620.75
BANKNIFTY19JUL1827400PE_2018-07-18.csv,15,7,8,1507.5,150921.0
BANKNIFTY19JUL1826600CE_2018-07-19.csv,17,5,12,-1821.75,148626.0
BANKNIFTY19JUL1826700CE_2018-07-19.csv,10,4,6,-700.5,51754.5
BANKNIFTY19JUL1826800CE_2018-07-19.csv,10,4,6,-582.0,26522.25
BANKNIFTY19JUL1826800PE_2018-07-19.csv,18,8,10,309.75,10134.75
BANKNIFTY19JUL1826900CE_2018-07-19.csv,12,7,5,67.5,10869.75
BANKNIFTY19JUL1826900PE_2018-07-19.csv,10,4,6,-57.0,16632.75
BANKNIFTY19JUL1827000CE_2018-07-19.csv,15,10,5,126.0,5129.25
BANKNIFTY19JUL1827000PE_2018-07-19.csv,16,6,10,297.0,57107.25
BANKNIFTY19JUL1827100PE_2018-07-19.csv,13,8,5,1703.25,82095.0
BANKNIFTY19JUL1827200PE_2018-07-19.csv,14,4,10,-889.5,123417.0
BANKNIFTY26JUL1826000PE_2018-07-20.csv,13,7,6,129.75,9674.25
BANKNIFTY26JUL1826100PE_2018-07-20.csv,9,3,6,19.5,7954.5
BANKNIFTY26JUL1826200PE_2018-07-20.csv,9,3,6,-12.75,9012.75
BANKNIFTY26JUL1826300PE_2018-07-20.csv,13,3,10,-196.5,16656.0
BANKNIFTY26JUL1826400PE_2018-07-20.csv,10,3,7,-170.25,15811.5
BANKNIFTY26JUL1826500PE_2018-07-20.csv,9,2,7,-244.5,18243.0
BANKNIFTY26JUL1826600PE_2018-07-20.csv,10,4,6,130.5,26746.5
BANKNIFTY26JUL1826700CE_2018-07-20.csv,8,4,4,432.0,80034.0
BANKNIFTY26JUL1826700PE_2018-07-20.csv,6,2,4,96.0,20221.5
BANKNIFTY26JUL1826800CE_2018-07-20.csv,8,3,5,-472.5,63615.0
BANKNIFTY26JUL1826800PE_2018-07-20.csv,7,2,5,-244.5,30468.0
BANKNIFTY26JUL1826900CE_2018-07-20.csv,6,3,3,145.5,37432.5
BANKNIFTY26JUL1826900PE_2018-07-20.csv,10,4,6,275.25,58370.25
BANKNIFTY26JUL1827000CE_2018-07-20.csv,8,3,5,-381.0,36408.0
BANKNIFTY26JUL1827000PE_2018-07-20.csv,8,1,7,-1206.75,59124.75
BANKNIFTY26JUL1827100CE_2018-07-20.csv,10,5,5,20.25,32997.0
BANKNIFTY26JUL1827100PE_2018-07-20.csv,1,0,1,-450.75,13151.25
BANKNIFTY26JUL1827200CE_2018-07-20.csv,8,4,4,34.5,17851.5
BANKNIFTY26JUL1827300CE_2018-07-20.csv,9,4,5,-21.75,14538.75
BANKNIFTY26JUL1827400CE_2018-07-20.csv,12,5,7,-51.0,14495.25
BANKNIFTY26JUL1827500CE_2018-07-20.csv,11,5,6,-32.25,9652.5
BANKNIFTY26JUL1826200PE_2018-07-23.csv,8,3,5,-20.25,3312.75
BANKNIFTY26JUL1826300PE_2018-07-23.csv,14,3,11,-141.75,7652.25
BANKNIFTY26JUL1826400PE_2018-07-23.csv,7,1,6,-207.0,5305.5
BANKNIFTY26JUL1826500PE_2018-07-23.csv,7,1,6,-207.0,7230.0
BANKNIFTY26JUL1826600PE_2018-07-23.csv,8,1,7,-408.75,12066.75
BANKNIFTY26JUL1826700CE_2018-07-23.csv,6,3,3,536.25,65493.0
BANKNIFTY26JUL1826700PE_2018-07-23.csv,9,3,6,-108.0,18904.5
BANKNIFTY26JUL1826800CE_2018-07-23.csv,3,1,2,-5.25,25447.5
BANKNIFTY26JUL1826800PE_2018-07-23.csv,7,2,5,-447.75,19346.25
BANKNIFTY26JUL1826900CE_2018-07-23.csv,4,2,2,215.25,25620.75
BANKNIFTY26JUL1826900PE_2018-07-23.csv,5,1,4,-586.5,21504.0
BANKNIFTY26JUL1827000CE_2018-07-23.csv,6,3,3,174.0,26694.0
BANKNIFTY26JUL1827000PE_2018-07-23.csv,5,0,5,-1061.25,23436.75
BANKNIFTY26JUL1827100CE_2018-07-23.csv,6,1,5,-350.25,17193.75
BANKNIFTY26JUL1827100PE_2018-07-23.csv,7,1,6,-879.75,47451.75
BANKNIFTY26JUL1827200CE_2018-07-23.csv,7,3,4,36.75,15054.75
BANKNIFTY26JUL1827300CE_2018-07-23.csv,8,2,6,-139.5,11766.0
BANKNIFTY26JUL1827400CE_2018-07-23.csv,7,2,5,-59.25,6612.75
BANKNIFTY26JUL1826600PE_2018-07-24.csv,12,4,8,-6.75,7476.75
BANKNIFTY26JUL1826700CE_2018-07-24.csv,9,3,6,-1544.25,100508.25
BANKNIFTY26JUL1826700PE_2018-07-24.csv,11,5,6,42.0,9517.5
BANKNIFTY26JUL1826800CE_2018-07-24.csv,7,2,5,-1324.5,68033.25
BANKNIFTY26JUL1826800PE_2018-07-24.csv,7,3,4,-21.75,8765.25
BANKNIFTY26JUL1826900CE_2018-07-24.csv,7,3,4,-635.25,55147.5
BANKNIFTY26JUL1826900PE_2018-07-24.csv,7,2,5,-234.0,13522.5
BANKNIFTY26JUL1827000CE_2018-07-24.csv,6,1,5,-1269.75,30854.25
BANKNIFTY26JUL1827000PE_2018-07-24.csv,9,4,5,70.5,25941.0
BANKNIFTY26JUL1827100CE_2018-07-24.csv,5,1,4,-1182.75,17229.75
BANKNIFTY26JUL1827100PE_2018-07-24.csv,9,4,5,459.75,39266.25
BANKNIFTY26JUL1827200CE_2018-07-24.csv,4,0,4,-460.5,11016.0
BANKNIFTY26JUL1827200PE_2018-07-24.csv,9,3,6,8.25,58317.75
BANKNIFTY26JUL1827300CE_2018-07-24.csv,6,1,5,-164.25,9636.75
BANKNIFTY26JUL1827300PE_2018-07-24.csv,14,5,9,1131.0,122032.5
BANKNIFTY26JUL1827400CE_2018-07-24.csv,7,1,6,-387.0,6171.0
BANKNIFTY26JUL1827500CE_2018-07-24.csv,12,5,7,-144.75,7871.25
BANKNIFTY26JUL1826700PE_2018-07-25.csv,11,5,6,1.5,5797.5
BANKNIFTY26JUL1826800CE_2018-07-25.csv,10,4,6,267.75,82265.25
BANKNIFTY26JUL1826800PE_2018-07-25.csv,11,6,5,87.0,9812.25
BANKNIFTY26JUL1826900CE_2018-07-25.csv,10,3,7,-565.5,61048.5
BANKNIFTY26JUL1826900PE_2018-07-25.csv,9,5,4,156.75,13220.25
BANKNIFTY26JUL1827000CE_2018-07-25.csv,11,5,6,508.5,45139.5
BANKNIFTY26JUL1827000PE_2018-07-25.csv,6,2,4,-247.5,14103.0
BANKNIFTY26JUL1827100CE_2018-07-25.csv,9,3,6,-231.75,22535.25
BANKNIFTY26JUL1827100PE_2018-07-25.csv,9,5,4,366.0,31816.5
BANKNIFTY26JUL1827200CE_2018-07-25.csv,6,2,4,0.0,9025.5
BANKNIFTY26JUL1827200PE_2018-07-25.csv,10,6,4,1036.5,57860.25
BANKNIFTY26JUL1827300CE_2018-07-25.csv,7,2,5,-57.75,5513.25
BANKNIFTY26JUL1827300PE_2018-07-25.csv,12,7,5,1632.0,95725.5
BANKNIFTY26JUL1826800CE_2018-07-26.csv,6,4,2,2350.5,94353.0
BANKNIFTY26JUL1826900CE_2018-07-26.csv,9,4,5,578.25,102872.25
BANKNIFTY26JUL1827000CE_2018-07-26.csv,6,2,4,-137.25,59220.75
BANKNIFTY26JUL1827000PE_2018-07-26.csv,27,10,17,-33.0,2289.75
BANKNIFTY26JUL1827100CE_2018-07-26.csv,6,3,3,387.75,33129.75
BANKNIFTY26JUL1827100PE_2018-07-26.csv,15,6,9,-130.5,3567.75
BANKNIFTY26JUL1827200CE_2018-07-26.csv,6,1,5,-637.5,17463.0
BANKNIFTY26JUL1827200PE_2018-07-26.csv,8,3,5,-61.5,1775.25
BANKNIFTY26JUL1827300CE_2018-07-26.csv,11,1,10,-524.25,12747.75
BANKNIFTY26JUL1827300PE_2018-07-26.csv,7,2,5,-435.75,9609.0
BANKNIFTY26JUL1827400PE_2018-07-26.csv,8,1,7,-910.5,34349.25
BANKNIFTY26JUL1827500PE_2018-07-26.csv,13,1,12,-3201.75,90683.25
BANKNIFTY02AUG1826800PE_2018-07-27.csv,9,2,7,-105.0,4683.0
BANKNIFTY02AUG1826900PE_2018-07-27.csv,9,1,8,-178.5,5837.25
BANKNIFTY02AUG1827000PE_2018-07-27.csv,5,0,5,-225.0,4699.5
BANKNIFTY02AUG1827100PE_2018-07-27.csv,5,0,5,-271.5,6620.25
BANKNIFTY02AUG1827200PE_2018-07-27.csv,4,1,3,-210.75,7898.25
BANKNIFTY02AUG1827300CE_2018-07-27.csv,4,2,2,416.25,44100.0
BANKNIFTY02AUG1827300PE_2018-07-27.csv,7,0,7,-825.0,20323.5
BANKNIFTY02AUG1827400CE_2018-07-27.csv,3,2,1,279.75,27476.25
BANKNIFTY02AUG1827400PE_2018-07-27.csv,6,1,5,-573.75,22130.25
BANKNIFTY02AUG1827500CE_2018-07-27.csv,4,2,2,54.75,27694.5
BANKNIFTY02AUG1827500PE_2018-07-27.csv,4,1,3,-309.75,18716.25
BANKNIFTY02AUG1827600CE_2018-07-27.csv,3,2,1,303.75,13830.75
BANKNIFTY02AUG1827600PE_2018-07-27.csv,6,1,5,-715.5,40637.25
BANKNIFTY02AUG1827700CE_2018-07-27.csv,2,1,1,-26.25,8828.25
BANKNIFTY02AUG1827700PE_2018-07-27.csv,8,1,7,-1220.25,62780.25
BANKNIFTY02AUG1827800CE_2018-07-27.csv,5,3,2,50.25,12498.75
BANKNIFTY02AUG1827900CE_2018-07-27.csv,4,3,1,108.0,6487.5
BANKNIFTY02AUG1828000CE_2018-07-27.csv,7,3,4,50.25,8213.25
BANKNIFTY02AUG1828100CE_2018-07-27.csv,13,5,8,-22.5,9583.5
BANKNIFTY02AUG1827100PE_2018-07-30.csv,7,1,6,-102.0,4434.75
BANKNIFTY02AUG1827200PE_2018-07-30.csv,7,1,6,-112.5,6492.0
BANKNIFTY02AUG1827300PE_2018-07-30.csv,7,1,6,-162.0,9913.5
BANKNIFTY02AUG1827400CE_2018-07-30.csv,7,4,3,1496.25,80617.5
BANKNIFTY02AUG1827400PE_2018-07-30.csv,7,1,6,-253.5,12339.0
BANKNIFTY02AUG1827500CE_2018-07-30.csv,7,4,3,1251.75,63729.75
BANKNIFTY02AUG1827500PE_2018-07-30.csv,7,1,6,-345.75,18436.5
BANKNIFTY02AUG1827600CE_2018-07-30.csv,6,3,3,551.25,41510.25
BANKNIFTY02AUG1827600PE_2018-07-30.csv,7,0,7,-775.5,22522.5
BANKNIFTY02AUG1827700CE_2018-07-30.csv,8,4,4,402.0,41626.5
BANKNIFTY02AUG1827700PE_2018-07-30.csv,10,2,8,-582.0,46948.5
BANKNIFTY02AUG1827800CE_2018-07-30.csv,6,2,4,-4.5,19978.5
BANKNIFTY02AUG1827800PE_2018-07-30.csv,8,2,6,-608.25,48636.75
BANKNIFTY02AUG1827900CE_2018-07-30.csv,8,4,4,174.0,18420.0
BANKNIFTY02AUG1827900PE_2018-07-30.csv,11,2,9,-1470.0,86340.0
BANKNIFTY02AUG1828000CE_2018-07-30.csv,6,2,4,-45.75,9152.25
BANKNIFTY02AUG1828000PE_2018-07-30.csv,11,2,9,-1626.0,110280.75
BANKNIFTY02AUG1828100CE_2018-07-30.csv,12,4,8,-67.5,10297.5
BANKNIFTY02AUG1827300PE_2018-07-31.csv,10,4,6,30.75,7563.75
BANKNIFTY02AUG1827400PE_2018-07-31.csv,10,4,6,29.25,10965.75
BANKNIFTY02AUG1827500CE_2018-07-31.csv,4,1,3,-438.0,39044.25
BANKNIFTY02AUG1827500PE_2018-07-31.csv,6,2,4,-84.0,10235.25
BANKNIFTY02AUG1827600CE_2018-07-31.csv,8,3,5,20.25,55140.75
BANKNIFTY02AUG1827600PE_2018-07-31.csv,4,2,2,69.75,9426.75
BANKNIFTY02AUG1827700CE_2018-07-31.csv,7,4,3,538.5,35406.0
BANKNIFTY02AUG1827700PE_2018-07-31.csv,6,4,2,566.25,22326.75
BANKNIFTY02AUG1827800CE_2018-07-31.csv,6,2,4,-114.0,20493.0
BANKNIFTY02AUG1827800PE_2018-07-31.csv,7,2,5,-196.5,35286.0
BANKNIFTY02AUG1827900CE_2018-07-31.csv,9,3,6,-96.0,19699.5
BANKNIFTY02AUG1827900PE_2018-07-31.csv,7,2,5,-509.25,47890.5
BANKNIFTY02AUG1828000CE_2018-07-31.csv,8,3,5,4.5,10282.5
BANKNIFTY02AUG1828000PE_2018-07-31.csv,10,4,6,91.5,89164.5
BANKNIFTY02AUG1828100CE_2018-07-31.csv,9,3,6,-36.75,6887.25
BANKNIFTY02AUG1827400PE_2018-08-01.csv,7,2,5,-156.0,5172.0
BANKNIFTY02AUG1827500CE_2018-08-01.csv,10,2,8,-1473.75,70688.25
BANKNIFTY02AUG1827500PE_2018-08-01.csv,6,2,4,-128.25,8693.25
BANKNIFTY02AUG1827600CE_2018-08-01.csv,6,0,6,-1173.75,31148.25
BANKNIFTY02AUG1827600PE_2018-08-01.csv,9,3,6,-223.5,20136.0
BANKNIFTY02AUG1827700CE_2018-08-01.csv,7,2,5,-555.0,23343.0
BANKNIFTY02AUG1827700PE_2018-08-01.csv,6,2,4,-313.5,20056.5
BANKNIFTY02AUG1827800CE_2018-08-01.csv,8,2,6,-625.5,18394.5
BANKNIFTY02AUG1827800PE_2018-08-01.csv,7,3,4,-67.5,35527.5
BANKNIFTY02AUG1827900CE_2018-08-01.csv,7,1,6,-339.75,8504.25
BANKNIFTY02AUG1827900PE_2018-08-01.csv,11,5,6,588.0,79032.0
BANKNIFTY02AUG1828000CE_2018-08-01.csv,11,1,10,-314.25,8034.75
BANKNIFTY02AUG1828000PE_2018-08-01.csv,6,3,3,798.75,55026.75
BANKNIFTY02AUG1827200CE_2018-08-02.csv,13,6,7,642.75,72701.25
BANKNIFTY02AUG1827300CE_2018-08-02.csv,13,5,8,-102.75,40716.75
BANKNIFTY02AUG1827300PE_2018-08-02.csv,16,6,10,-165.0,4991.25
BANKNIFTY02AUG1827400CE_2018-08-02.csv,14,6,8,195.0,14922.75
BANKNIFTY02AUG1827400PE_2018-08-02.csv,8,5,3,207.75,11351.25
BANKNIFTY02AUG1827500CE_2018-08-02.csv,17,8,9,108.75,6628.5
BANKNIFTY02AUG1827500PE_2018-08-02.csv,7,4,3,161.25,21996.75
BANKNIFTY02AUG1827600CE_2018-08-02.csv,27,14,13,15.0,1842.75
BANKNIFTY02AUG1827600PE_2018-08-02.csv,8,4,4,427.5,50079.0
BANKNIFTY02AUG1827700PE_2018-08-02.csv,8,4,4,814.5,72603.0
BANKNIFTY02AUG1827800PE_2018-08-02.csv,6,3,3,930.75,74580.0
BANKNIFTY09AUG1827000PE_2018-08-03.csv,11,0,11,-160.5,5215.5
BANKNIFTY09AUG1827100PE_2018-08-03.csv,6,0,6,-143.25,4589.25
BANKNIFTY09AUG1827200PE_2018-08-03.csv,8,1,7,138.75,8894.25
BANKNIFTY09AUG1827300CE_2018-08-03.csv,5,5,0,3161.25,58581.75
BANKNIFTY09AUG1827300PE_2018-08-03.csv,9,0,9,-387.75,11528.25
BANKNIFTY09AUG1827400CE_2018-08-03.csv,3,3,0,1345.5,32644.5
BANKNIFTY09AUG1827400PE_2018-08-03.csv,8,0,8,-512.25,16408.5
BANKNIFTY09AUG1827500CE_2018-08-03.csv,4,3,1,1288.5,30955.5
BANKNIFTY09AUG1827500PE_2018-08-03.csv,10,0,10,-918.75,27729.75
BANKNIFTY09AUG1827600CE_2018-08-03.csv,4,4,0,1344.0,26749.5
BANKNIFTY09AUG1827600PE_2018-08-03.csv,8,0,8,-999.0,29713.5
BANKNIFTY09AUG1827700CE_2018-08-03.csv,3,3,0,656.25,12092.25
BANKNIFTY09AUG1827700PE_2018-08-03.csv,10,0,10,-1838.25,56084.25
BANKNIFTY09AUG1827800CE_2018-08-03.csv,3,3,0,456.75,8699.25
BANKNIFTY09AUG1827800PE_2018-08-03.csv,9,0,9,-2178.0,66294.0
BANKNIFTY09AUG1827900CE_2018-08-03.csv,5,4,1,306.0,8712.0
BANKNIFTY09AUG1828000CE_2018-08-03.csv,4,3,1,160.5,4525.5
BANKNIFTY09AUG1827400PE_2018-08-06.csv,7,3,4,42.75,4111.5
BANKNIFTY09AUG1827500PE_2018-08-06.csv,7,4,3,127.5,5508.0
BANKNIFTY09AUG1827600CE_2018-08-06.csv,4,2,2,377.25,49553.25
BANKNIFTY09AUG1827600PE_2018-08-06.csv,7,2,5,-26.25,7865.25
BANKNIFTY09AUG1827700CE_2018-08-06.csv,8,4,4,444.75,74412.0
BANKNIFTY09AUG1827700PE_2018-08-06.csv,7,4,3,234.75,10958.25
BANKNIFTY09AUG1827800CE_2018-08-06.csv,7,2,5,-578.25,47909.25
BANKNIFTY09AUG1827800PE_2018-08-06.csv,7,4,3,388.5,17307.0
BANKNIFTY09AUG1827900CE_2018-08-06.csv,10,3,7,-539.25,48248.25
BANKNIFTY09AUG1827900PE_2018-08-06.csv,10,4,6,261.0,33967.5
BANKNIFTY09AUG1828000CE_2018-08-06.csv,10,4,6,-149.25,32619.0
BANKNIFTY09AUG1828000PE_2018-08-06.csv,10,4,6,238.5,50211.0
BANKNIFTY09AUG1828100CE_2018-08-06.csv,10,4,6,20.25,20409.75
BANKNIFTY09AUG1828100PE_2018-08-06.csv,12,3,9,-691.5,79435.5
BANKNIFTY09AUG1828200CE_2018-08-06.csv,10,3,7,-219.75,13193.25
BANKNIFTY09AUG1828200PE_2018-08-06.csv,10,3,7,-274.5,91693.5
BANKNIFTY09AUG1827500PE_2018-08-07.csv,11,3,8,-90.0,8130.0
BANKNIFTY09AUG1827600CE_2018-08-07.csv,5,2,3,68.25,54189.0
BANKNIFTY09AUG1827600PE_2018-08-07.csv,8,1,7,-150.0,9063.0
BANKNIFTY09AUG1827700CE_2018-08-07.csv,7,2,5,-258.0,55752.0
BANKNIFTY09AUG1827700PE_2018-08-07.csv,7,2,5,-93.75,12668.25
BANKNIFTY09AUG1827800CE_2018-08-07.csv,6,2,4,-84.0,32076.0
BANKNIFTY09AUG1827800PE_2018-08-07.csv,6,1,5,-289.5,16108.5
BANKNIFTY09AUG1827900CE_2018-08-07.csv,8,3,5,-76.5,28645.5
BANKNIFTY09AUG1827900PE_2018-08-07.csv,7,2,5,-141.75,26111.25
BANKNIFTY09AUG1828000CE_2018-08-07.csv,10,5,5,266.25,22605.75
BANKNIFTY09AUG1828000PE_2018-08-07.csv,7,2,5,-132.0,35727.0
BANKNIFTY09AUG1828100CE_2018-08-07.csv,8,2,6,-136.5,10842.75
BANKNIFTY09AUG1828100PE_2018-08-07.csv,8,2,6,-631.5,58916.25
BANKNIFTY09AUG1828200CE_2018-08-07.csv,9,3,6,-18.0,6617.25
BANKNIFTY09AUG1828200PE_2018-08-07.csv,5,0,5,-1541.25,50738.25
BANKNIFTY09AUG1828300CE_2018-08-07.csv,13,5,8,6.0,4391.25
BANKNIFTY09AUG1827600CE_2018-08-08.csv,7,4,3,1209.75,89670.0
BANKNIFTY09AUG1827700CE_2018-08-08.csv,7,3,4,40.5,63058.5
BANKNIFTY09AUG1827700PE_2018-08-08.csv,9,3,6,15.75,4400.25
BANKNIFTY09AUG1827800CE_2018-08-08.csv,6,2,4,-244.5,43000.5
BANKNIFTY09AUG1827800PE_2018-08-08.csv,8,2,6,16.5,5985.0
BANKNIFTY09AUG1827900CE_2018-08-08.csv,6,2,4,-103.5,31081.5
BANKNIFTY09AUG1827900PE_2018-08-08.csv,12,5,7,119.25,14738.25
BANKNIFTY09AUG1828000CE_2018-08-08.csv,6,2,4,-63.0,18537.0
BANKNIFTY09AUG1828000PE_2018-08-08.csv,8,4,4,386.25,15800.25
BANKNIFTY09AUG1828100CE_2018-08-08.csv,9,4,5,-20.25,15863.25
BANKNIFTY09AUG1828100PE_2018-08-08.csv,10,3,7,-177.75,37149.75
BANKNIFTY09AUG1828200CE_2018-08-08.csv,9,4,5,21.0,8361.0
BANKNIFTY09AUG1828200PE_2018-08-08.csv,11,4,7,-147.0,58318.5
BANKNIFTY09AUG1828300PE_2018-08-08.csv,12,3,9,-1620.0,101319.75
BANKNIFTY09AUG1827900CE_2018-08-09.csv,8,6,2,2731.5,81277.5
BANKNIFTY09AUG1828000CE_2018-08-09.csv,11,6,5,861.75,80609.25
BANKNIFTY09AUG1828100CE_2018-08-09.csv,8,4,4,207.75,35009.25
BANKNIFTY09AUG1828100PE_2018-08-09.csv,31,10,21,-107.25,3940.5
BANKNIFTY09AUG1828200CE_2018-08-09.csv,11,7,4,678.0,22798.5
BANKNIFTY09AUG1828200PE_2018-08-09.csv,21,10,11,-277.5,8961.75
BANKNIFTY09AUG1828300CE_2018-08-09.csv,10,3,7,-103.5,5805.0
BANKNIFTY09AUG1828300PE_2018-08-09.csv,13,5,8,-135.0,18528.75
BANKNIFTY09AUG1828400PE_2018-08-09.csv,13,6,7,198.75,51323.25
BANKNIFTY09AUG1828500PE_2018-08-09.csv,12,3,9,-1180.5,80607.0
BANKNIFTY16AUG1827700PE_2018-08-10.csv,8,5,3,90.0,6942.0
BANKNIFTY16AUG1827800PE_2018-08-10.csv,6,4,2,163.5,7566.0
BANKNIFTY16AUG1827900PE_2018-08-10.csv,7,5,2,315.75,12240.75
BANKNIFTY16AUG1828000CE_2018-08-10.csv,7,1,6,-1293.0,67257.0
BANKNIFTY16AUG1828000PE_2018-08-10.csv,6,4,2,351.75,13520.25
BANKNIFTY16AUG1828100CE_2018-08-10.csv,8,1,7,-1229.25,58676.25
BANKNIFTY16AUG1828100PE_2018-08-10.csv,7,5,2,588.0,23376.0
BANKNIFTY16AUG1828200CE_2018-08-10.csv,10,1,9,-1407.75,52573.5
BANKNIFTY16AUG1828200PE_2018-08-10.csv,6,4,2,706.5,25579.5
BANKNIFTY16AUG1828300CE_2018-08-10.csv,8,0,8,-994.5,31425.75
BANKNIFTY16AUG1828300PE_2018-08-10.csv,5,2,3,332.25,28593.75
BANKNIFTY16AUG1828400CE_2018-08-10.csv,10,2,8,-426.75,24836.25
BANKNIFTY16AUG1828400PE_2018-08-10.csv,8,5,3,1639.5,59392.5
BANKNIFTY16AUG1828500CE_2018-08-10.csv,7,0,7,-471.75,12431.25
BANKNIFTY16AUG1828500PE_2018-08-10.csv,8,5,3,1610.25,82599.75
BANKNIFTY16AUG1828600CE_2018-08-10.csv,8,2,6,-72.0,8925.0
BANKNIFTY16AUG1828700CE_2018-08-10.csv,11,1,10,-224.25,7913.25
BANKNIFTY16AUG1828800CE_2018-08-10.csv,14,4,10,-66.75,6338.25
BANKNIFTY16AUG1827300PE_2018-08-13.csv,10,2,8,-114.0,5535.0
BANKNIFTY16AUG1827400PE_2018-08-13.csv,7,1,6,-159.0,5500.5
BANKNIFTY16AUG1827500PE_2018-08-13.csv,7,1,6,-174.0,7594.5
BANKNIFTY16AUG1827600CE_2018-08-13.csv,9,4,5,448.5,88146.0
BANKNIFTY16AUG1827600PE_2018-08-13.csv,7,0,7,-402.0,10770.0
BANKNIFTY16AUG1827700CE_2018-08-13.csv,9,4,5,-67.5,67858.5
BANKNIFTY16AUG1827700PE_2018-08-13.csv,6,1,5,-347.25,13275.75
BANKNIFTY16AUG1827800CE_2018-08-13.csv,9,4,5,30.75,48575.25
BANKNIFTY16AUG1827800PE_2018-08-13.csv,7,3,4,8.25,22302.75
BANKNIFTY16AUG1827900CE_2018-08-13.csv,9,5,4,633.75,33626.25
BANKNIFTY16AUG1827900PE_2018-08-13.csv,5,2,3,-18.75,24069.0
BANKNIFTY16AUG1828000CE_2018-08-13.csv,13,5,8,-68.25,33658.5
BANKNIFTY16AUG1828000PE_2018-08-13.csv,7,2,5,-141.0,41455.5
BANKNIFTY16AUG1828100CE_2018-08-13.csv,11,6,5,150.0,17542.5
BANKNIFTY16AUG1828100PE_2018-08-13.csv,7,0,7,-1792.5,57381.0
BANKNIFTY16AUG1828200CE_2018-08-13.csv,16,8,8,101.25,15825.75
BANKNIFTY16AUG1828200PE_2018-08-13.csv,10,3,7,-768.75,107384.25
BANKNIFTY16AUG1828300CE_2018-08-13.csv,7,3,4,28.5,4284.0
BANKNIFTY16AUG1827500PE_2018-08-14.csv,10,6,4,39.0,2217.75
BANKNIFTY16AUG1827600PE_2018-08-14.csv,14,5,9,-44.25,4910.25
BANKNIFTY16AUG1827700CE_2018-08-14.csv,7,4,3,1086.75,70014.75
BANKNIFTY16AUG1827700PE_2018-08-14.csv,10,4,6,21.75,5769.75
BANKNIFTY16AUG1827800CE_2018-08-14.csv,8,4,4,756.75,59778.75
BANKNIFTY16AUG1827800PE_2018-08-14.csv,6,2,4,-110.25,6162.0
BANKNIFTY16AUG1827900CE_2018-08-14.csv,9,4,5,319.5,46807.5
BANKNIFTY16AUG1827900PE_2018-08-14.csv,10,4,6,36.75,15320.25
BANKNIFTY16AUG1828000CE_2018-08-14.csv,10,3,7,-177.75,33753.75
BANKNIFTY16AUG1828000PE_2018-08-14.csv,13,4,9,-315.0,35118.0
BANKNIFTY16AUG1828100CE_2018-08-14.csv,10,4,6,65.25,19416.75
BANKNIFTY16AUG1828100PE_2018-08-14.csv,11,4,7,-186.0,45288.0
BANKNIFTY16AUG1828200CE_2018-08-14.csv,13,5,8,42.0,13486.5
BANKNIFTY16AUG1828200PE_2018-08-14.csv,12,4,8,-660.75,74225.25
BANKNIFTY16AUG1828300PE_2018-08-14.csv,9,2,7,-1363.5,75799.5
BANKNIFTY16AUG1827700CE_2018-08-16.csv,15,6,9,177.75,92166.75
BANKNIFTY16AUG1827800CE_2018-08-16.csv,14,5,9,-519.0,47079.0
BANKNIFTY16AUG1827800PE_2018-08-16.csv,18,7,11,-67.5,3429.75
BANKNIFTY16AUG1827900CE_2018-08-16.csv,15,6,9,-105.75,16306.5
BANKNIFTY16AUG1827900PE_2018-08-16.csv,10,5,5,-150.75,11979.75
BANKNIFTY16AUG1828000CE_2018-08-16.csv,22,11,11,39.0,6221.25
BANKNIFTY16AUG1828000PE_2018-08-16.csv,11,5,6,246.75,33558.75
BANKNIFTY16AUG1828100PE_2018-08-16.csv,11,7,4,1046.25,57141.75
BANKNIFTY16AUG1828200PE_2018-08-16.csv,13,6,7,638.25,102257.25
BANKNIFTY23AUG1827500PE_2018-08-17.csv,7,2,5,-66.75,4423.5
BANKNIFTY23AUG1827600PE_2018-08-17.csv,10,4,6,3.75,8204.25
BANKNIFTY23AUG1827700PE_2018-08-17.csv,8,1,7,-210.75,10095.75
BANKNIFTY23AUG1827800CE_2018-08-17.csv,8,4,4,1089.0,92556.0
BANKNIFTY23AUG1827800PE_2018-08-17.csv,6,1,5,-187.5,10363.5
BANKNIFTY23AUG1827900CE_2018-08-17.csv,4,3,1,1129.5,38121.0
BANKNIFTY23AUG1827900PE_2018-08-17.csv,7,2,5,-111.75,17261.25
BANKNIFTY23AUG1828000CE_2018-08-17.csv,5,3,2,669.0,32556.0
BANKNIFTY23AUG1828000PE_2018-08-17.csv,4,3,1,475.5,13953.0
BANKNIFTY23AUG1828100CE_2018-08-17.csv,5,2,3,-42.0,26833.5
BANKNIFTY23AUG1828100PE_2018-08-17.csv,6,1,5,-429.75,29431.5
BANKNIFTY23AUG1828200CE_2018-08-17.csv,5,2,3,83.25,16800.75
BANKNIFTY23AUG1828200PE_2018-08-17.csv,6,2,4,-90.0,40359.0
BANKNIFTY23AUG1828300CE_2018-08-17.csv,5,2,3,5.25,11160.75
BANKNIFTY23AUG1828300PE_2018-08-17.csv,7,1,6,-1525.5,59292.0
BANKNIFTY23AUG1828400CE_2018-08-17.csv,8,5,3,315.75,11735.25
BANKNIFTY23AUG1828500CE_2018-08-17.csv,10,6,4,173.25,9879.75
BANKNIFTY23AUG1827800PE_2018-08-20.csv,6,2,4,14.25,2912.25
BANKNIFTY23AUG1827900PE_2018-08-20.csv,5,3,2,133.5,3433.5
BANKNIFTY23AUG1828000CE_2018-08-20.csv,2,0,2,-747.0,25731.0
BANKNIFTY23AUG1828000PE_2018-08-20.csv,4,2,2,111.75,4173.75
BANKNIFTY23AUG1828100CE_2018-08-20.csv,2,1,1,-171.0,19767.0
BANKNIFTY23AUG1828100PE_2018-08-20.csv,5,3,2,243.75,7860.75
BANKNIFTY23AUG1828200CE_2018-08-20.csv,3,1,2,-416.25,21261.75
BANKNIFTY23AUG1828200PE_2018-08-20.csv,4,2,2,254.25,8924.25
BANKNIFTY23AUG1828300CE_2018-08-20.csv,3,1,2,-330.75,14784.75
BANKNIFTY23AUG1828300PE_2018-08-20.csv,5,3,2,525.0,16518.0
BANKNIFTY23AUG1828400CE_2018-08-20.csv,3,1,2,-275.25,9861.0
BANKNIFTY23AUG1828400PE_2018-08-20.csv,5,2,3,214.5,24018.0
BANKNIFTY23AUG1828500CE_2018-08-20.csv,2,1,1,-128.25,4265.25
BANKNIFTY23AUG1828500PE_2018-08-20.csv,4,1,3,76.5,29789.25
BANKNIFTY23AUG1828600CE_2018-08-20.csv,4,2,2,-59.25,4572.75
BANKNIFTY23AUG1828000CE_2018-08-21.csv,7,3,4,295.5,53266.5
BANKNIFTY23AUG1828000PE_2018-08-21.csv,9,2,7,-49.5,7549.5
BANKNIFTY23AUG1828100CE_2018-08-21.csv,7,3,4,175.5,38076.0
BANKNIFTY23AUG1828100PE_2018-08-21.csv,9,3,6,-16.5,12910.5
BANKNIFTY23AUG1828200CE_2018-08-21.csv,6,2,4,-204.75,21785.25
BANKNIFTY23AUG1828200PE_2018-08-21.csv,7,2,5,-58.5,17343.0
BANKNIFTY23AUG1828300CE_2018-08-21.csv,7,2,5,-180.75,14808.75
BANKNIFTY23AUG1828300PE_2018-08-21.csv,5,2,3,4.5,21367.5
BANKNIFTY23AUG1828400CE_2018-08-21.csv,7,2,5,-96.0,8152.5
BANKNIFTY23AUG1828400PE_2018-08-21.csv,7,2,5,-213.75,39792.75
BANKNIFTY23AUG1828500CE_2018-08-21.csv,11,4,7,-0.75,6519.75
BANKNIFTY23AUG1828500PE_2018-08-21.csv,9,2,7,-729.0,71533.5
BANKNIFTY23AUG1828600CE_2018-08-21.csv,12,7,5,17.25,2885.25
BANKNIFTY23AUG1827800CE_2018-08-23.csv,11,1,10,-2507.25,97069.5
BANKNIFTY23AUG1827900CE_2018-08-23.csv,10,1,9,-1836.0,60195.0
BANKNIFTY23AUG1828000CE_2018-08-23.csv,8,3,5,-390.75,21755.25
BANKNIFTY23AUG1828100CE_2018-08-23.csv,14,6,8,-256.5,10758.75
BANKNIFTY23AUG1828100PE_2018-08-23.csv,9,3,6,-262.5,11004.0
BANKNIFTY23AUG1828200CE_2018-08-23.csv,22,5,17,-362.25,6838.5
BANKNIFTY23AUG1828200PE_2018-08-23.csv,6,2,4,-492.75,18021.75
BANKNIFTY23AUG1828300CE_2018-08-23.csv,41,21,20,-39.0,1935.75
BANKNIFTY23AUG1828300PE_2018-08-23.csv,9,5,4,537.75,62990.25
BANKNIFTY23AUG1828400CE_2018-08-23.csv,58,34,24,-1.5,945.75
BANKNIFTY23AUG1828400PE_2018-08-23.csv,11,7,4,1859.25,101237.25
BANKNIFTY23AUG1828500PE_2018-08-23.csv,7,4,3,1412.25,90208.5
BANKNIFTY30AUG1827400PE_2018-08-24.csv,12,7,5,183.0,12337.5
BANKNIFTY30AUG1827500PE_2018-08-24.csv,9,5,4,179.25,12876.0
BANKNIFTY30AUG1827600PE_2018-08-24.csv,8,6,2,483.0,15639.75
BANKNIFTY30AUG1827700CE_2018-08-24.csv,13,2,11,-2349.75,145517.25
BANKNIFTY30AUG1827700PE_2018-08-24.csv,9,5,4,336.0,22851.0
BANKNIFTY30AUG1827800CE_2018-08-24.csv,11,2,9,-1636.5,92634.0
BANKNIFTY30AUG1827800PE_2018-08-24.csv,8,4,4,174.75,25122.0
BANKNIFTY30AUG1827900CE_2018-08-24.csv,11,2,9,-1584.0,74379.0
BANKNIFTY30AUG1827900PE_2018-08-24.csv,7,3,4,91.5,31621.5
BANKNIFTY30AUG1828000CE_2018-08-24.csv,6,0,6,-1061.25,31728.75
BANKNIFTY30AUG1828000PE_2018-08-24.csv,6,3,3,252.75,33311.25
BANKNIFTY30AUG1828100CE_2018-08-24.csv,6,2,4,-204.0,22791.0
BANKNIFTY30AUG1828100PE_2018-08-24.csv,10,6,4,1194.75,75417.75
BANKNIFTY30AUG1828200CE_2018-08-24.csv,6,1,5,-432.75,17702.25
BANKNIFTY30AUG1828200PE_2018-08-24.csv,9,5,4,1057.5,84781.5
BANKNIFTY30AUG1828300CE_2018-08-24.csv,11,0,11,-674.25,20850.75
BANKNIFTY30AUG1828300PE_2018-08-24.csv,9,5,4,1564.5,102060.75
BANKNIFTY30AUG1828400CE_2018-08-24.csv,14,3,11,-362.25,17093.25
BANKNIFTY30AUG1828500CE_2018-08-24.csv,13,3,10,-214.5,11031.75
BANKNIFTY30AUG1828600CE_2018-08-24.csv,11,2,9,-124.5,5604.0
BANKNIFTY30AUG1827500PE_2018-08-27.csv,8,2,6,-23.25,2471.25
BANKNIFTY30AUG1827600PE_2018-08-27.csv,5,1,4,-38.25,2006.25
BANKNIFTY30AUG1827700PE_2018-08-27.csv,5,1,4,-47.25,2594.25
BANKNIFTY30AUG1827800PE_2018-08-27.csv,6,2,4,-45.75,4275.75
BANKNIFTY30AUG1827900CE_2018-08-27.csv,2,1,1,314.25,27765.75
BANKNIFTY30AUG1827900PE_2018-08-27.csv,6,2,4,-21.0,5283.0
BANKNIFTY30AUG1828000CE_2018-08-27.csv,2,2,0,857.25,21945.0
BANKNIFTY30AUG1828000PE_2018-08-27.csv,8,2,6,-123.0,11050.5
BANKNIFTY30AUG1828100CE_2018-08-27.csv,4,3,1,816.75,25491.75
BANKNIFTY30AUG1828100PE_2018-08-27.csv,5,1,4,-177.0,10878.75
BANKNIFTY30AUG1828200CE_2018-08-27.csv,6,4,2,681.0,29430.0
BANKNIFTY30AUG1828200PE_2018-08-27.csv,8,2,6,-249.0,26471.25
BANKNIFTY30AUG1828300CE_2018-08-27.csv,6,3,3,208.5,19995.0
BANKNIFTY30AUG1828300PE_2018-08-27.csv,8,1,7,-689.25,36117.75
BANKNIFTY30AUG1828400CE_2018-08-27.csv,8,5,3,348.75,16970.25
BANKNIFTY30AUG1828400PE_2018-08-27.csv,6,1,5,-740.25,41898.75
BANKNIFTY30AUG1828500CE_2018-08-27.csv,9,5,4,188.25,11259.75
BANKNIFTY30AUG1828500PE_2018-08-27.csv,5,0,5,-1455.0,50775.0
BANKNIFTY30AUG1827900PE_2018-08-28.csv,9,3,6,0.0,7726.5
BANKNIFTY30AUG1828000CE_2018-08-28.csv,9,3,6,-375.0,75300.75
BANKNIFTY30AUG1828000PE_2018-08-28.csv,10,3,7,-104.25,14243.25
BANKNIFTY30AUG1828100CE_2018-08-28.csv,10,4,6,-184.5,62838.0
BANKNIFTY30AUG1828100PE_2018-08-28.csv,7,2,5,-107.25,15647.25
BANKNIFTY30AUG1828200CE_2018-08-28.csv,4,2,2,-233.25,19706.25
BANKNIFTY30AUG1828200PE_2018-08-28.csv,11,3,8,-248.25,33590.25
BANKNIFTY30AUG1828300CE_2018-08-28.csv,6,1,5,-228.0,15814.5
BANKNIFTY30AUG1828300PE_2018-08-28.csv,7,2,5,-405.75,35376.75
BANKNIFTY30AUG1828400CE_2018-08-28.csv,6,3,3,90.0,10129.5
BANKNIFTY30AUG1828400PE_2018-08-28.csv,10,3,7,-521.25,66423.75
BANKNIFTY30AUG1828500CE_2018-08-28.csv,7,1,6,-162.75,8712.0
BANKNIFTY30AUG1828500PE_2018-08-28.csv,9,2,7,-1338.75,81554.25
BANKNIFTY30AUG1828600CE_2018-08-28.csv,8,1,7,-132.75,5249.25
BANKNIFTY30AUG1828000CE_2018-08-29.csv,6,3,3,458.25,65193.75
BANKNIFTY30AUG1828000PE_2018-08-29.csv,8,4,4,40.5,5686.5
BANKNIFTY30AUG1828100CE_2018-08-29.csv,8,4,4,1029.0,59115.0
BANKNIFTY30AUG1828100PE_2018-08-29.csv,11,4,7,12.75,11748.75
BANKNIFTY30AUG1828200CE_2018-08-29.csv,8,3,5,-24.75,40655.25
BANKNIFTY30AUG1828200PE_2018-08-29.csv,6,2,4,-85.5,11591.25
BANKNIFTY30AUG1828300CE_2018-08-29.csv,11,5,6,246.75,37310.25
BANKNIFTY30AUG1828300PE_2018-08-29.csv,10,4,6,-119.25,28975.5
BANKNIFTY30AUG1828400CE_2018-08-29.csv,11,6,5,519.0,21894.0
BANKNIFTY30AUG1828400PE_2018-08-29.csv,8,3,5,-255.75,37098.75
BANKNIFTY30AUG1828500CE_2018-08-29.csv,10,5,5,86.25,10469.25
BANKNIFTY30AUG1828500PE_2018-08-29.csv,9,2,7,-1203.75,60111.0
BANKNIFTY30AUG1828600CE_2018-08-29.csv,14,7,7,58.5,6160.5
BANKNIFTY30AUG1828600PE_2018-08-29.csv,9,3,6,-531.0,79956.75
BANKNIFTY30AUG1827800CE_2018-08-30.csv,12,5,7,-54.75,84581.25
BANKNIFTY30AUG1827900CE_2018-08-30.csv,14,4,10,-955.5,62460.0
BANKNIFTY30AUG1828000CE_2018-08-30.csv,7,1,6,-724.5,18477.0
BANKNIFTY30AUG1828000PE_2018-08-30.csv,16,7,9,-47.25,9237.75
BANKNIFTY30AUG1828100CE_2018-08-30.csv,16,5,11,-589.5,14519.25
BANKNIFTY30AUG1828100PE_2018-08-30.csv,14,6,8,50.25,27966.0
BANKNIFTY30AUG1828200CE_2018-08-30.csv,22,10,12,-93.75,3673.5
BANKNIFTY30AUG1828200PE_2018-08-30.csv,9,3,6,81.75,38768.25
BANKNIFTY30AUG1828300CE_2018-08-30.csv,28,11,17,-9.0,1505.25
BANKNIFTY30AUG1828300PE_2018-08-30.csv,10,5,5,997.5,76096.5
BANKNIFTY30AUG1828400PE_2018-08-30.csv,6,2,4,-751.5,63276.0
BANKNIFTY30AUG1828500PE_2018-08-30.csv,8,3,5,153.0,104431.5
BANKNIFTY06SEP1827500PE_2018-08-31.csv,14,5,9,-9.0,9676.5
BANKNIFTY06SEP1827600PE_2018-08-31.csv,9,4,5,141.0,8870.25
BANKNIFTY06SEP1827700PE_2018-08-31.csv,9,2,7,-179.25,11974.5
BANKNIFTY06SEP1827800PE_2018-08-31.csv,8,1,7,-324.75,14835.75
BANKNIFTY06SEP1827900CE_2018-08-31.csv,7,3,4,179.25,62913.75
BANKNIFTY06SEP1827900PE_2018-08-31.csv,10,3,7,-133.5,24955.5
BANKNIFTY06SEP1828000CE_2018-08-31.csv,4,1,3,-549.0,33428.25
BANKNIFTY06SEP1828000PE_2018-08-31.csv,7,0,7,-895.5,23517.0
BANKNIFTY06SEP1828100CE_2018-08-31.csv,9,4,5,50.25,53339.25
BANKNIFTY06SEP1828100PE_2018-08-31.csv,4,2,2,456.0,20833.5
BANKNIFTY06SEP1828200CE_2018-08-31.csv,6,2,4,-357.75,26591.25
BANKNIFTY06SEP1828200PE_2018-08-31.csv,7,1,6,-867.75,43993.5
BANKNIFTY06SEP1828300CE_2018-08-31.csv,6,3,3,-90.0,19599.0
BANKNIFTY06SEP1828300PE_2018-08-31.csv,10,2,8,-1041.0,80436.75
BANKNIFTY06SEP1828400CE_2018-08-31.csv,8,4,4,108.75,16959.75
BANKNIFTY06SEP1828500CE_2018-08-31.csv,7,3,4,-10.5,9740.25
BANKNIFTY06SEP1828600CE_2018-08-31.csv,12,5,7,29.25,9536.25
BANKNIFTY06SEP1827700PE_2018-09-03.csv,7,4,3,144.75,5868.75
BANKNIFTY06SEP1827800PE_2018-09-03.csv,6,3,3,81.75,7442.25
BANKNIFTY06SEP1827900CE_2018-09-03.csv,6,1,5,-667.5,42192.0
BANKNIFTY06SEP1827900PE_2018-09-03.csv,7,3,4,38.25,13632.75
BANKNIFTY06SEP1828000CE_2018-09-03.csv,8,1,7,-1044.75,44222.25
BANKNIFTY06SEP1828000PE_2018-09-03.csv,6,3,3,216.0,20044.5
BANKNIFTY06SEP1828100CE_2018-09-03.csv,8,1,7,-715.5,32749.5
BANKNIFTY06SEP1828100PE_2018-09-03.csv,6,3,3,178.5,25462.5
BANKNIFTY06SEP1828200CE_2018-09-03.csv,7,2,5,-244.5,21762.0
BANKNIFTY06SEP1828200PE_2018-09-03.csv,6,2,4,-113.25,34905.75
BANKNIFTY06SEP1828300CE_2018-09-03.csv,7,1,6,-321.75,13772.25
BANKNIFTY06SEP1828300PE_2018-09-03.csv,7,4,3,1157.25,55394.25
BANKNIFTY06SEP1828400CE_2018-09-03.csv,10,1,9,-340.5,11136.0
BANKNIFTY06SEP1828500CE_2018-09-03.csv,8,1,7,-147.0,6196.5
BANKNIFTY06SEP1828600CE_2018-09-03.csv,14,2,12,-210.75,5666.25
BANKNIFTY06SEP1827400PE_2018-09-04.csv,10,3,7,-202.5,13363.5
BANKNIFTY06SEP1827500CE_2018-09-04.csv,11,2,9,-1883.25,89018.25
BANKNIFTY06SEP1827500PE_2018-09-04.csv,8,3,5,-223.5,17542.5
BANKNIFTY06SEP1827600CE_2018-09-04.csv,9,3,6,-312.0,44397.0
BANKNIFTY06SEP1827600PE_2018-09-04.csv,9,4,5,-194.25,29648.25
BANKNIFTY06SEP1827700CE_2018-09-04.csv,13,4,9,-772.5,45508.5
BANKNIFTY06SEP1827700PE_2018-09-04.csv,8,3,5,-39.0,40143.0
BANKNIFTY06SEP1827800CE_2018-09-04.csv,13,3,10,-672.0,32136.0
BANKNIFTY06SEP1827800PE_2018-09-04.csv,6,2,4,-501.75,41984.25
BANKNIFTY06SEP1827900CE_2018-09-04.csv,14,4,10,-274.5,17338.5
BANKNIFTY06SEP1827900PE_2018-09-04.csv,10,5,5,543.0,85417.5
BANKNIFTY06SEP1828000CE_2018-09-04.csv,17,3,14,-250.5,12145.5
BANKNIFTY06SEP1828000PE_2018-09-04.csv,10,6,4,1641.75,104274.75
BANKNIFTY06SEP1828100CE_2018-09-04.csv,13,2,11,-164.25,6357.0
BANKNIFTY06SEP1828100PE_2018-09-04.csv,9,5,4,2139.75,116933.25
BANKNIFTY06SEP1828200CE_2018-09-04.csv,16,3,13,-111.75,5310.75
BANKNIFTY06SEP1828200PE_2018-09-04.csv,8,4,4,1667.25,122543.25
BANKNIFTY06SEP1827000CE_2018-09-05.csv,15,4,11,-936.75,154289.25
BANKNIFTY06SEP1827100CE_2018-09-05.csv,15,1,14,-2596.5,122904.0
BANKNIFTY06SEP1827100PE_2018-09-05.csv,10,5,5,141.0,8428.5
BANKNIFTY06SEP1827200CE_2018-09-05.csv,11,2,9,-1572.0,71890.5
BANKNIFTY06SEP1827200PE_2018-09-05.csv,12,8,4,292.5,13974.0
BANKNIFTY06SEP1827300CE_2018-09-05.csv,9,1,8,-882.75,41400.75
BANKNIFTY06SEP1827300PE_2018-09-05.csv,12,9,3,986.25,28689.75
BANKNIFTY06SEP1827400CE_2018-09-05.csv,10,3,7,-205.5,24217.5
BANKNIFTY06SEP1827400PE_2018-09-05.csv,12,9,3,1734.75,47472.75
BANKNIFTY06SEP1827500CE_2018-09-05.csv,8,1,7,-248.25,14684.25
BANKNIFTY06SEP1827500PE_2018-09-05.csv,10,7,3,1427.25,59919.75
BANKNIFTY06SEP1827600CE_2018-09-05.csv,11,2,9,-98.25,9536.25
BANKNIFTY06SEP1827600PE_2018-09-05.csv,12,6,6,235.5,96237.0
BANKNIFTY06SEP1827700CE_2018-09-05.csv,12,1,11,-86.25,5022.75
BANKNIFTY06SEP1827700PE_2018-09-05.csv,9,5,4,1208.25,90234.75
BANKNIFTY06SEP1827800CE_2018-09-05.csv,16,3,13,-69.0,3714.0
BANKNIFTY06SEP1827800PE_2018-09-05.csv,14,7,7,1389.0,184098.0
BANKNIFTY06SEP1827000CE_2018-09-06.csv,13,5,8,330.75,158079.75
BANKNIFTY06SEP1827100CE_2018-09-06.csv,17,6,11,-563.25,156828.75
BANKNIFTY06SEP1827200CE_2018-09-06.csv,11,3,8,-486.75,70144.5
BANKNIFTY06SEP1827300CE_2018-09-06.csv,14,2,12,-1209.75,45767.25
BANKNIFTY06SEP1827300PE_2018-09-06.csv,21,9,12,-69.0,4163.25
BANKNIFTY06SEP1827400CE_2018-09-06.csv,15,5,10,-292.5,22482.0
BANKNIFTY06SEP1827400PE_2018-09-06.csv,14,3,11,-654.75,13282.5
BANKNIFTY06SEP1827500CE_2018-09-06.csv,16,4,12,-214.5,6071.25
BANKNIFTY06SEP1827500PE_2018-09-06.csv,13,3,10,-826.5,38015.25
BANKNIFTY06SEP1827600PE_2018-09-06.csv,13,4,9,-1584.0,71022.0
BANKNIFTY06SEP1827700PE_2018-09-06.csv,16,6,10,-1071.75,127691.25
BANKNIFTY06SEP1827800PE_2018-09-06.csv,14,4,10,-1604.25,161616.75
BANKNIFTY12SEP1826800PE_2018-09-07.csv,16,6,10,-24.75,10983.75
BANKNIFTY12SEP1826900PE_2018-09-07.csv,15,8,7,141.0,14103.0
BANKNIFTY12SEP1827000PE_2018-09-07.csv,15,6,9,-100.5,21001.5
BANKNIFTY12SEP1827100PE_2018-09-07.csv,13,4,9,-294.0,25749.0
BANKNIFTY12SEP1827200CE_2018-09-07.csv,10,4,6,868.5,96074.25
BANKNIFTY12SEP1827200PE_2018-09-07.csv,9,2,7,-531.0,24291.0
BANKNIFTY12SEP1827300CE_2018-09-07.csv,10,3,7,-766.5,74116.5
BANKNIFTY12SEP1827300PE_2018-09-07.csv,9,3,6,-533.25,32271.75
BANKNIFTY12SEP1827400CE_2018-09-07.csv,8,5,3,1212.0,44002.5
BANKNIFTY12SEP1827400PE_2018-09-07.csv,9,4,5,-336.0,41986.5
BANKNIFTY12SEP1827500CE_2018-09-07.csv,9,4,5,207.0,35355.75
BANKNIFTY12SEP1827500PE_2018-09-07.csv,11,5,6,-150.0,64872.0
BANKNIFTY12SEP1827600CE_2018-09-07.csv,7,3,4,74.25,18785.25
BANKNIFTY12SEP1827600PE_2018-09-07.csv,12,4,8,-676.5,94626.0
BANKNIFTY12SEP1827700CE_2018-09-07.csv,10,4,6,138.0,17869.5
BANKNIFTY12SEP1827700PE_2018-09-07.csv,11,3,8,-1530.0,106861.5
BANKNIFTY12SEP1827800CE_2018-09-07.csv,13,4,9,-165.0,14374.5
BANKNIFTY12SEP1827900CE_2018-09-07.csv,11,3,8,-69.75,7865.25
BANKNIFTY12SEP1826900PE_2018-09-10.csv,10,5,5,60.75,8624.25
BANKNIFTY12SEP1827000CE_2018-09-10.csv,12,3,9,-975.75,119870.25
BANKNIFTY12SEP1827000PE_2018-09-10.csv,9,4,5,-24.0,11829.0
BANKNIFTY12SEP1827100CE_2018-09-10.csv,12,3,9,-927.0,88143.0
BANKNIFTY12SEP1827100PE_2018-09-10.csv,8,4,4,213.75,16368.75
BANKNIFTY12SEP1827200CE_2018-09-10.csv,13,5,8,162.75,69902.25
BANKNIFTY12SEP1827200PE_2018-09-10.csv,8,4,4,118.5,25866.75
BANKNIFTY12SEP1827300CE_2018-09-10.csv,9,4,5,366.75,36674.25
BANKNIFTY12SEP1827300PE_2018-09-10.csv,7,2,5,-583.5,32409.0
BANKNIFTY12SEP1827400CE_2018-09-10.csv,12,5,7,69.0,30508.5
BANKNIFTY12SEP1827400PE_2018-09-10.csv,6,4,2,538.5,34966.5
BANKNIFTY12SEP1827500CE_2018-09-10.csv,10,5,5,23.25,17381.25
BANKNIFTY12SEP1827500PE_2018-09-10.csv,8,6,2,1643.25,60230.25
BANKNIFTY12SEP1827600CE_2018-09-10.csv,11,5,6,81.75,11259.75
BANKNIFTY12SEP1827600PE_2018-09-10.csv,8,5,3,1158.0,82800.0
BANKNIFTY12SEP1827700CE_2018-09-10.csv,14,4,10,-32.25,8255.25
BANKNIFTY12SEP1827000CE_2018-09-11.csv,11,5,6,645.0,73881.0
BANKNIFTY12SEP1827000PE_2018-09-11.csv,13,6,7,283.5,13180.5
BANKNIFTY12SEP1827100CE_2018-09-11.csv,12,4,8,-110.25,60716.25
BANKNIFTY12SEP1827100PE_2018-09-11.csv,11,4,7,-105.75,12537.75
BANKNIFTY12SEP1827200CE_2018-09-11.csv,7,1,6,-442.5,21661.5
BANKNIFTY12SEP1827200PE_2018-09-11.csv,9,4,5,24.75,22506.75
BANKNIFTY12SEP1827300CE_2018-09-11.csv,7,2,5,-240.75,13554.75
BANKNIFTY12SEP1827300PE_2018-09-11.csv,8,4,4,726.75,34397.25
BANKNIFTY12SEP1827400CE_2018-09-11.csv,9,3,6,-28.5,13627.5
BANKNIFTY12SEP1827400PE_2018-09-11.csv,7,2,5,-376.5,41668.5
BANKNIFTY12SEP1827500CE_2018-09-11.csv,11,2,9,-273.0,9378.0
BANKNIFTY12SEP1827500PE_2018-09-11.csv,7,4,3,596.25,56062.5
BANKNIFTY12SEP1827600CE_2018-09-11.csv,11,4,7,-6.0,5439.0
BANKNIFTY12SEP1827600PE_2018-09-11.csv,13,7,6,2555.25,140477.25
BANKNIFTY12SEP1826400CE_2018-09-12.csv,18,8,10,735.75,172618.5
BANKNIFTY12SEP1826500CE_2018-09-12.csv,18,8,10,-347.25,125259.75
BANKNIFTY12SEP1826500PE_2018-09-12.csv,25,12,13,-36.75,2518.5
BANKNIFTY12SEP1826600CE_2018-09-12.csv,9,4,5,-496.5,35139.75
BANKNIFTY12SEP1826600PE_2018-09-12.csv,16,7,9,-60.75,6706.5
BANKNIFTY12SEP1826700CE_2018-09-12.csv,10,5,5,-37.5,21796.5
BANKNIFTY12SEP1826700PE_2018-09-12.csv,14,6,8,-150.75,15154.5
BANKNIFTY12SEP1826800CE_2018-09-12.csv,9,4,5,-112.5,11512.5
BANKNIFTY12SEP1826800PE_2018-09-12.csv,13,5,8,-430.5,38594.25
BANKNIFTY12SEP1826900CE_2018-09-12.csv,17,7,10,-111.75,4015.5
BANKNIFTY12SEP1826900PE_2018-09-12.csv,10,3,7,-147.0,48405.0
BANKNIFTY12SEP1827000CE_2018-09-12.csv,27,12,15,-52.5,1674.75
BANKNIFTY12SEP1827000PE_2018-09-12.csv,8,5,3,1649.25,62349.75
BANKNIFTY12SEP1827100PE_2018-09-12.csv,13,6,7,532.5,129955.5
BANKNIFTY19SEP1826400PE_2018-09-14.csv,11,5,6,29.25,6411.75
BANKNIFTY19SEP1826500PE_2018-09-14.csv,8,5,3,132.75,6876.75
BANKNIFTY19SEP1826600PE_2018-09-14.csv,8,4,4,79.5,8626.5
BANKNIFTY19SEP1826700PE_2018-09-14.csv,11,4,7,-32.25,14873.25
BANKNIFTY19SEP1826800CE_2018-09-14.csv,9,3,6,-775.5,105705.0
BANKNIFTY19SEP1826800PE_2018-09-14.csv,11,6,5,228.75,21767.25
BANKNIFTY19SEP1826900CE_2018-09-14.csv,8,3,5,-82.5,74951.25
BANKNIFTY19SEP1826900PE_2018-09-14.csv,5,1,4,-382.5,13430.25
BANKNIFTY19SEP1827000CE_2018-09-14.csv,8,2,6,-753.0,55656.0
BANKNIFTY19SEP1827000PE_2018-09-14.csv,8,3,5,-75.0,29344.5
BANKNIFTY19SEP1827100CE_2018-09-14.csv,10,4,6,-185.25,53733.75
BANKNIFTY19SEP1827100PE_2018-09-14.csv,8,2,6,-762.0,37290.0
BANKNIFTY19SEP1827200CE_2018-09-14.csv,8,4,4,144.75,35244.75
BANKNIFTY19SEP1827200PE_2018-09-14.csv,6,1,5,-1005.0,38634.0
BANKNIFTY19SEP1827300CE_2018-09-14.csv,6,2,4,-198.75,18371.25
BANKNIFTY19SEP1827300PE_2018-09-14.csv,8,2,6,-812.25,66323.25
BANKNIFTY19SEP1827400CE_2018-09-14.csv,6,1,5,-418.5,13773.0
BANKNIFTY19SEP1827500CE_2018-09-14.csv,10,4,6,-159.75,15149.25
BANKNIFTY19SEP1827600CE_2018-09-14.csv,10,5,5,16.5,10974.75
BANKNIFTY19SEP1827700CE_2018-09-14.csv,11,3,8,-73.5,7909.5
BANKNIFTY19SEP1826300PE_2018-09-17.csv,13,4,9,-112.5,8892.75
BANKNIFTY19SEP1826400PE_2018-09-17.csv,12,6,6,120.75,12135.75
BANKNIFTY19SEP1826500PE_2018-09-17.csv,13,4,9,-264.0,18657.0
BANKNIFTY19SEP1826600CE_2018-09-17.csv,13,4,9,-1089.75,121350.75
BANKNIFTY19SEP1826600PE_2018-09-17.csv,11,3,8,-205.5,21187.5
BANKNIFTY19SEP1826700CE_2018-09-17.csv,11,4,7,-259.5,75159.0
BANKNIFTY19SEP1826700PE_2018-09-17.csv,14,6,8,-60.0,39475.5
BANKNIFTY19SEP1826800CE_2018-09-17.csv,12,5,7,-75.0,62611.5
BANKNIFTY19SEP1826800PE_2018-09-17.csv,10,3,7,-339.0,39098.25
BANKNIFTY19SEP1826900CE_2018-09-17.csv,10,4,6,-51.75,35250.75
BANKNIFTY19SEP1826900PE_2018-09-17.csv,9,3,6,-356.25,48936.0
BANKNIFTY19SEP1827000CE_2018-09-17.csv,10,2,8,-523.5,24481.5
BANKNIFTY19SEP1827000PE_2018-09-17.csv,11,3,8,-909.0,78272.25
BANKNIFTY19SEP1827100CE_2018-09-17.csv,10,3,7,-137.25,14874.75
BANKNIFTY19SEP1827100PE_2018-09-17.csv,11,6,5,1514.25,99588.75
BANKNIFTY19SEP1827200CE_2018-09-17.csv,12,5,7,16.5,11857.5
BANKNIFTY19SEP1827200PE_2018-09-17.csv,10,3,7,-377.25,116304.75
BANKNIFTY19SEP1827300CE_2018-09-17.csv,11,2,9,-147.0,6244.5
BANKNIFTY19SEP1827400CE_2018-09-17.csv,12,5,7,0.75,4430.25
BANKNIFTY19SEP1826400PE_2018-09-18.csv,14,8,6,358.5,10042.5
BANKNIFTY19SEP1826500CE_2018-09-18.csv,13,2,11,-3929.25,96168.75
BANKNIFTY19SEP1826500PE_2018-09-18.csv,8,6,2,648.75,9981.75
BANKNIFTY19SEP1826600CE_2018-09-18.csv,8,1,7,-2119.5,49038.75
BANKNIFTY19SEP1826600PE_2018-09-18.csv,10,5,5,210.0,20086.5
BANKNIFTY19SEP1826700CE_2018-09-18.csv,8,2,6,-1211.25,25341.75
BANKNIFTY19SEP1826700PE_2018-09-18.csv,9,3,6,78.0,28717.5
BANKNIFTY19SEP1826800CE_2018-09-18.csv,6,2,4,-829.5,16230.0
BANKNIFTY19SEP1826800PE_2018-09-18.csv,9,6,3,2141.25,48231.0
BANKNIFTY19SEP1826900CE_2018-09-18.csv,9,3,6,-634.5,12184.5
BANKNIFTY19SEP1826900PE_2018-09-18.csv,9,5,4,2168.25,61134.75
BANKNIFTY19SEP1827000CE_2018-09-18.csv,8,3,5,-18.0,6636.0
BANKNIFTY19SEP1827000PE_2018-09-18.csv,10,7,3,3910.5,89550.0
BANKNIFTY19SEP1827100CE_2018-09-18.csv,11,4,7,-55.5,4933.5
BANKNIFTY19SEP1827100PE_2018-09-18.csv,12,7,5,3315.75,151889.25
BANKNIFTY19SEP1827200CE_2018-09-18.csv,11,2,9,-80.25,3350.25
BANKNIFTY19SEP1827200PE_2018-09-18.csv,11,7,4,5664.0,171804.75
BANKNIFTY19SEP1826200CE_2018-09-19.csv,14,1,13,-3612.0,101998.5
BANKNIFTY19SEP1826300CE_2018-09-19.csv,11,3,8,-549.0,52427.25
BANKNIFTY19SEP1826400CE_2018-09-19.csv,12,4,8,-282.75,21991.5
BANKNIFTY19SEP1826400PE_2018-09-19.csv,9,5,4,348.75,13361.25
BANKNIFTY19SEP1826500CE_2018-09-19.csv,15,4,11,-240.0,13371.75
BANKNIFTY19SEP1826500PE_2018-09-19.csv,9,5,4,222.0,17758.5
BANKNIFTY19SEP1826600CE_2018-09-19.csv,19,8,11,-229.5,6756.75
BANKNIFTY19SEP1826600PE_2018-09-19.csv,9,3,6,-276.0,39000.0
BANKNIFTY19SEP1826700CE_2018-09-19.csv,31,18,13,40.5,2465.25
BANKNIFTY19SEP1826700PE_2018-09-19.csv,6,2,4,-614.25,36855.75
BANKNIFTY19SEP1826800PE_2018-09-19.csv,10,5,5,1290.75,97826.25
BANKNIFTY27SEP1825800PE_2018-09-21.csv,13,7,6,-581.25,63555.0
BANKNIFTY27SEP1825900PE_2018-09-21.csv,15,6,9,-2248.5,109350.0
BANKNIFTY27SEP1826000CE_2018-09-21.csv,12,1,11,-2844.75,110522.25
BANKNIFTY27SEP1826000PE_2018-09-21.csv,14,4,10,-3887.25,103793.25
BANKNIFTY27SEP1826100PE_2018-09-21.csv,13,4,9,-5295.75,121084.5
BANKNIFTY27SEP1826200CE_2018-09-21.csv,13,1,12,-2233.5,82653.0
BANKNIFTY27SEP1826200PE_2018-09-21.csv,13,5,8,-1008.0,121749.0
BANKNIFTY27SEP1826300CE_2018-09-21.csv,8,2,6,-1001.25,44479.5
BANKNIFTY27SEP1826300PE_2018-09-21.csv,10,4,6,-419.25,141377.25
BANKNIFTY27SEP1826400CE_2018-09-21.csv,11,5,6,4.5,37587.0
BANKNIFTY27SEP1826400PE_2018-09-21.csv,12,6,6,259.5,168285.0
BANKNIFTY27SEP1826500CE_2018-09-21.csv,12,3,9,-240.75,25784.25
BANKNIFTY27SEP1826500PE_2018-09-21.csv,11,4,7,-2114.25,192018.75
BANKNIFTY27SEP1826600CE_2018-09-21.csv,11,6,5,-14.25,18621.75
BANKNIFTY27SEP1826600PE_2018-09-21.csv,12,6,6,457.5,202908.75
BANKNIFTY27SEP1826700CE_2018-09-21.csv,11,3,8,-306.0,14346.0
BANKNIFTY27SEP1826700PE_2018-09-21.csv,15,7,8,-3018.75,302282.25
BANKNIFTY27SEP1826800CE_2018-09-21.csv,9,1,8,-391.5,10632.0
BANKNIFTY27SEP1826900CE_2018-09-21.csv,17,5,12,-198.75,13625.25
BANKNIFTY27SEP1827000CE_2018-09-21.csv,14,2,12,-267.75,8474.25
BANKNIFTY27SEP1827100CE_2018-09-21.csv,16,2,14,-208.5,6727.5
BANKNIFTY27SEP1824000PE_2018-09-24.csv,14,11,3,805.5,11637.0
BANKNIFTY27SEP1824200PE_2018-09-24.csv,15,10,5,546.0,18909.0
BANKNIFTY27SEP1824300PE_2018-09-24.csv,16,8,8,385.5,24033.0
BANKNIFTY27SEP1824400PE_2018-09-24.csv,10,6,4,451.5,18440.25
BANKNIFTY27SEP1824500PE_2018-09-24.csv,11,7,4,832.5,25140.0
BANKNIFTY27SEP1824600PE_2018-09-24.csv,13,7,6,504.75,36580.5
BANKNIFTY27SEP1824700PE_2018-09-24.csv,12,7,5,753.0,43158.75
BANKNIFTY27SEP1824800PE_2018-09-24.csv,13,7,6,709.5,54633.0
BANKNIFTY27SEP1824900PE_2018-09-24.csv,10,6,4,902.25,46326.75
BANKNIFTY27SEP1825000PE_2018-09-24.csv,12,6,6,703.5,70618.5
BANKNIFTY27SEP1825100CE_2018-09-24.csv,17,4,13,-2652.75,184094.25
BANKNIFTY27SEP1825100PE_2018-09-24.csv,7,3,4,442.5,48906.0
BANKNIFTY27SEP1825200CE_2018-09-24.csv,13,3,10,-884.25,121008.75
BANKNIFTY27SEP1825200PE_2018-09-24.csv,13,7,6,1118.25,102276.75
BANKNIFTY27SEP1825300CE_2018-09-24.csv,16,5,11,-1572.75,102374.25
BANKNIFTY27SEP1825300PE_2018-09-24.csv,9,5,4,1117.5,82833.0
BANKNIFTY27SEP1825400CE_2018-09-24.csv,8,2,6,-718.5,34329.0
BANKNIFTY27SEP1825400PE_2018-09-24.csv,11,7,4,2170.5,121362.75
BANKNIFTY27SEP1825500CE_2018-09-24.csv,9,1,8,-1231.5,35773.5
BANKNIFTY27SEP1825500PE_2018-09-24.csv,14,9,5,3879.0,178174.5
BANKNIFTY27SEP1825600CE_2018-09-24.csv,10,3,7,-937.5,30849.0
BANKNIFTY27SEP1825600PE_2018-09-24.csv,10,7,3,2904.0,145182.0
BANKNIFTY27SEP1825700CE_2018-09-24.csv,9,3,6,-338.25,16382.25
BANKNIFTY27SEP1825700PE_2018-09-24.csv,14,9,5,4698.75,241869.0
BANKNIFTY27SEP1825800CE_2018-09-24.csv,10,2,8,-297.0,16035.0
BANKNIFTY27SEP1825800PE_2018-09-24.csv,16,10,6,6655.5,296814.0
BANKNIFTY27SEP1825900CE_2018-09-24.csv,12,3,9,-260.25,15871.5
BANKNIFTY27SEP1826000CE_2018-09-24.csv,11,2,9,-293.25,10830.75
BANKNIFTY27SEP1826100CE_2018-09-24.csv,11,2,9,-150.75,8105.25
BANKNIFTY27SEP1826200CE_2018-09-24.csv,13,5,8,-52.5,7456.5
BANKNIFTY27SEP1826300CE_2018-09-24.csv,12,3,9,-28.5,5654.25
BANKNIFTY27SEP1826400CE_2018-09-24.csv,13,2,11,-90.75,4553.25
BANKNIFTY27SEP1826500CE_2018-09-24.csv,12,4,8,9.0,3406.5
BANKNIFTY27SEP1823700PE_2018-09-25.csv,29,13,16,133.5,14314.5
BANKNIFTY27SEP1823800PE_2018-09-25.csv,29,13,16,93.75,18377.25
BANKNIFTY27SEP1823900PE_2018-09-25.csv,20,9,11,-39.75,16165.5
BANKNIFTY27SEP1824000PE_2018-09-25.csv,17,9,8,203.25,16259.25
BANKNIFTY27SEP1824100PE_2018-09-25.csv,16,6,10,-72.75,20265.75
BANKNIFTY27SEP1824200PE_2018-09-25.csv,13,8,5,450.75,19946.25
BANKNIFTY27SEP1824300PE_2018-09-25.csv,14,6,8,-179.25,25691.25
BANKNIFTY27SEP1824400PE_2018-09-25.csv,10,4,6,-588.0,20130.0
BANKNIFTY27SEP1824500PE_2018-09-25.csv,10,5,5,99.75,24779.25
BANKNIFTY27SEP1824600PE_2018-09-25.csv,13,6,7,-369.0,40294.5
BANKNIFTY27SEP1824700CE_2018-09-25.csv,11,5,6,1108.5,163318.5
BANKNIFTY27SEP1824700PE_2018-09-25.csv,10,3,7,-618.0,32947.5
BANKNIFTY27SEP1824800CE_2018-09-25.csv,11,6,5,1488.75,124217.25
BANKNIFTY27SEP1824800PE_2018-09-25.csv,11,5,6,-267.0,49861.5
BANKNIFTY27SEP1824900CE_2018-09-25.csv,13,5,8,297.0,124468.5
BANKNIFTY27SEP1824900PE_2018-09-25.csv,10,1,9,-2837.25,55403.25
BANKNIFTY27SEP1825000CE_2018-09-25.csv,10,4,6,-315.0,70125.0
BANKNIFTY27SEP1825000PE_2018-09-25.csv,9,4,5,-903.0,57748.5
BANKNIFTY27SEP1825100CE_2018-09-25.csv,15,5,10,-939.75,89371.5
BANKNIFTY27SEP1825100PE_2018-09-25.csv,13,2,11,-4776.75,113274.0
BANKNIFTY27SEP1825200CE_2018-09-25.csv,10,2,8,-844.5,49956.75
BANKNIFTY27SEP1825200PE_2018-09-25.csv,16,1,15,-7224.0,159723.0
BANKNIFTY27SEP1825300CE_2018-09-25.csv,8,3,5,39.0,27195.75
BANKNIFTY27SEP1825300PE_2018-09-25.csv,16,3,13,-6525.75,189338.25
BANKNIFTY27SEP1825400CE_2018-09-25.csv,11,4,7,-71.25,27212.25
BANKNIFTY27SEP1825400PE_2018-09-25.csv,25,8,17,-3516.0,329649.0
BANKNIFTY27SEP1825500CE_2018-09-25.csv,9,4,5,133.5,13858.5
BANKNIFTY27SEP1825600CE_2018-09-25.csv,9,4,5,160.5,13269.75
BANKNIFTY27SEP1825700CE_2018-09-25.csv,15,8,7,258.0,16089.0
BANKNIFTY27SEP1825800CE_2018-09-25.csv,13,7,6,156.0,10641.0
BANKNIFTY27SEP1825900CE_2018-09-25.csv,18,11,7,308.25,11313.75
BANKNIFTY27SEP1826000CE_2018-09-25.csv,12,6,6,51.75,5259.75
BANKNIFTY27SEP1824600PE_2018-09-26.csv,19,11,8,243.0,11326.5
BANKNIFTY27SEP1824700PE_2018-09-26.csv,13,6,7,120.0,10313.25
BANKNIFTY27SEP1824800PE_2018-09-26.csv,13,5,8,6.75,13928.25
BANKNIFTY27SEP1824900PE_2018-09-26.csv,13,7,6,240.75,19142.25
BANKNIFTY27SEP1825000PE_2018-09-26.csv,14,8,6,399.0,26608.5
BANKNIFTY27SEP1825100PE_2018-09-26.csv,9,6,3,492.0,22839.0
BANKNIFTY27SEP1825200CE_2018-09-26.csv,17,7,10,780.75,139760.25
BANKNIFTY27SEP1825200PE_2018-09-26.csv,11,6,5,831.75,36891.75
BANKNIFTY27SEP1825300CE_2018-09-26.csv,12,4,8,207.75,79329.75
BANKNIFTY27SEP1825300PE_2018-09-26.csv,11,6,5,725.25,46586.25
BANKNIFTY27SEP1825400CE_2018-09-26.csv,10,4,6,141.0,46579.5
BANKNIFTY27SEP1825400PE_2018-09-26.csv,13,8,5,1621.5,77109.0
BANKNIFTY27SEP1825500CE_2018-09-26.csv,11,5,6,43.5,38542.5
BANKNIFTY27SEP1825500PE_2018-09-26.csv,12,7,5,1326.0,85930.5
BANKNIFTY27SEP1825600CE_2018-09-26.csv,11,6,5,219.75,25713.75
BANKNIFTY27SEP1825600PE_2018-09-26.csv,16,6,10,-944.25,147203.25
BANKNIFTY27SEP1825700CE_2018-09-26.csv,15,6,9,-201.75,26780.25
BANKNIFTY27SEP1825800CE_2018-09-26.csv,13,7,6,170.25,15408.75
BANKNIFTY27SEP1825900CE_2018-09-26.csv,13,6,7,113.25,10241.25
BANKNIFTY27SEP1826000CE_2018-09-26.csv,13,5,8,-59.25,6492.75
BANKNIFTY27SEP1824900CE_2018-09-27.csv,16,2,14,-3269.25,122568.75
BANKNIFTY27SEP1825000CE_2018-09-27.csv,11,4,7,189.75,64061.25
BANKNIFTY27SEP1825000PE_2018-09-27.csv,17,8,9,126.75,8827.5
BANKNIFTY27SEP1825100CE_2018-09-27.csv,15,3,12,-778.5,49988.25
BANKNIFTY27SEP1825100PE_2018-09-27.csv,13,7,6,303.0,21408.0
BANKNIFTY27SEP1825200CE_2018-09-27.csv,13,3,10,-288.75,19588.5
BANKNIFTY27SEP1825200PE_2018-09-27.csv,12,6,6,105.0,39609.0
BANKNIFTY27SEP1825300CE_2018-09-27.csv,11,4,7,-207.0,11445.75
BANKNIFTY27SEP1825300PE_2018-09-27.csv,11,6,5,1545.0,67348.5
BANKNIFTY27SEP1825400CE_2018-09-27.csv,17,7,10,-15.75,7278.75
BANKNIFTY27SEP1825400PE_2018-09-27.csv,14,9,5,3213.75,110483.25
BANKNIFTY27SEP1825500CE_2018-09-27.csv,27,12,15,-226.5,5668.5
BANKNIFTY27SEP1825500PE_2018-09-27.csv,12,7,5,1990.5,128772.75
BANKNIFTY27SEP1825600CE_2018-09-27.csv,29,13,16,24.0,2230.5
BANKNIFTY27SEP1825600PE_2018-09-27.csv,15,11,4,6621.0,193036.5
BANKNIFTY27SEP1825700PE_2018-09-27.csv,10,5,5,2403.75,154263.0
BANKNIFTY04OCT1823600PE_2018-09-28.csv,27,11,16,-58.5,12094.5
BANKNIFTY04OCT1823700PE_2018-09-28.csv,30,16,14,191.25,16593.75
BANKNIFTY04OCT1823800PE_2018-09-28.csv,26,10,16,-352.5,17568.0
BANKNIFTY04OCT1823900PE_2018-09-28.csv,21,9,12,17.25,18614.25
BANKNIFTY04OCT1824000PE_2018-09-28.csv,12,4,8,-49.5,13134.0
BANKNIFTY04OCT1824100PE_2018-09-28.csv,16,6,10,-82.5,22507.5
BANKNIFTY04OCT1824200PE_2018-09-28.csv,13,3,10,-551.25,21843.75
BANKNIFTY04OCT1824300PE_2018-09-28.csv,12,4,8,-402.0,22980.75
BANKNIFTY04OCT1824400PE_2018-09-28.csv,12,6,6,318.0,27877.5
BANKNIFTY04OCT1824500PE_2018-09-28.csv,9,2,7,-361.5,24934.5
BANKNIFTY04OCT1824600PE_2018-09-28.csv,12,4,8,-344.25,39384.75
BANKNIFTY04OCT1824700PE_2018-09-28.csv,12,4,8,-675.0,49417.5
BANKNIFTY04OCT1824800PE_2018-09-28.csv,11,5,6,314.25,53058.75
BANKNIFTY04OCT1824900PE_2018-09-28.csv,9,3,6,-216.0,51391.5
BANKNIFTY04OCT1825000CE_2018-09-28.csv,15,8,7,2703.0,170860.5
BANKNIFTY04OCT1825000PE_2018-09-28.csv,12,5,7,303.75,82368.75
BANKNIFTY04OCT1825100CE_2018-09-28.csv,10,2,8,-1935.0,96012.75
BANKNIFTY04OCT1825100PE_2018-09-28.csv,10,2,8,-1880.25,75301.5
BANKNIFTY04OCT1825200CE_2018-09-28.csv,13,3,10,-1068.0,96580.5
BANKNIFTY04OCT1825200PE_2018-09-28.csv,8,2,6,-780.0,75819.0
BANKNIFTY04OCT1825300CE_2018-09-28.csv,11,2,9,-1389.0,63664.5
BANKNIFTY04OCT1825300PE_2018-09-28.csv,11,3,8,-806.25,120597.75
BANKNIFTY04OCT1825400CE_2018-09-28.csv,14,4,10,-467.25,65174.25
BANKNIFTY04OCT1825400PE_2018-09-28.csv,14,5,9,-645.75,172212.75
BANKNIFTY04OCT1825500CE_2018-09-28.csv,11,4,7,-53.25,39302.25
BANKNIFTY04OCT1825500PE_2018-09-28.csv,14,3,11,-3611.25,198506.25
BANKNIFTY04OCT1825600CE_2018-09-28.csv,11,3,8,-333.75,28634.25
BANKNIFTY04OCT1825700CE_2018-09-28.csv,9,1,8,-472.5,16548.0
BANKNIFTY04OCT1825800CE_2018-09-28.csv,10,3,7,-165.0,13674.0
BANKNIFTY04OCT1825900CE_2018-09-28.csv,14,6,8,-130.5,12597.0
BANKNIFTY04OCT1826000CE_2018-09-28.csv,8,3,5,-4.5,4867.5
BANKNIFTY04OCT1826200CE_2018-09-28.csv,13,4,9,-49.5,3346.5
BANKNIFTY04OCT1823800PE_2018-10-01.csv,19,8,11,-6.0,8124.0
BANKNIFTY04OCT1823900PE_2018-10-01.csv,15,5,10,-95.25,9897.75
BANKNIFTY04OCT1824000PE_2018-10-01.csv,11,2,9,-276.0,8262.0
BANKNIFTY04OCT1824100PE_2018-10-01.csv,14,2,12,-450.75,12989.25
BANKNIFTY04OCT1824200PE_2018-10-01.csv,7,1,6,-411.75,8421.75
BANKNIFTY04OCT1824300PE_2018-10-01.csv,6,2,4,66.75,10890.75
BANKNIFTY04OCT1824400PE_2018-10-01.csv,9,2,7,-578.25,17117.25
BANKNIFTY04OCT1824500PE_2018-10-01.csv,8,3,5,-339.75,20060.25
BANKNIFTY04OCT1824600PE_2018-10-01.csv,5,2,3,-288.75,22872.75
BANKNIFTY04OCT1824700PE_2018-10-01.csv,9,3,6,-577.5,44738.25
BANKNIFTY04OCT1824800CE_2018-10-01.csv,14,7,7,3205.5,184777.5
BANKNIFTY04OCT1824800PE_2018-10-01.csv,6,1,5,-1072.5,35089.5
BANKNIFTY04OCT1824900CE_2018-10-01.csv,13,6,7,2356.5,126637.5
BANKNIFTY04OCT1824900PE_2018-10-01.csv,7,2,5,-1449.75,38393.25
BANKNIFTY04OCT1825000CE_2018-10-01.csv,9,3,6,142.5,77982.0
BANKNIFTY04OCT1825000PE_2018-10-01.csv,7,2,5,-555.0,45938.25
BANKNIFTY04OCT1825100CE_2018-10-01.csv,11,7,4,2258.25,74139.75
BANKNIFTY04OCT1825200CE_2018-10-01.csv,9,5,4,782.25,51183.0
BANKNIFTY04OCT1825300CE_2018-10-01.csv,7,4,3,426.75,33550.5
BANKNIFTY04OCT1825400CE_2018-10-01.csv,12,7,5,584.25,40248.0
BANKNIFTY04OCT1825500CE_2018-10-01.csv,9,5,4,417.0,22471.5
BANKNIFTY04OCT1825600CE_2018-10-01.csv,11,9,2,998.25,20046.75
BANKNIFTY04OCT1825700CE_2018-10-01.csv,12,7,5,206.25,12743.25
BANKNIFTY04OCT1825800CE_2018-10-01.csv,14,5,9,-87.0,9615.0
BANKNIFTY04OCT1824500PE_2018-10-03.csv,20,7,13,-51.0,4647.0
BANKNIFTY04OCT1824600PE_2018-10-03.csv,14,6,8,-29.25,4413.75
BANKNIFTY04OCT1824700PE_2018-10-03.csv,15,7,8,19.5,7039.5
BANKNIFTY04OCT1824800PE_2018-10-03.csv,10,5,5,93.0,6666.0
BANKNIFTY04OCT1824900CE_2018-10-03.csv,20,7,13,-1512.0,245789.25
BANKNIFTY04OCT1824900PE_2018-10-03.csv,11,4,7,-41.25,12531.0
BANKNIFTY04OCT1825000CE_2018-10-03.csv,17,5,12,-1647.0,153588.0
BANKNIFTY04OCT1825000PE_2018-10-03.csv,10,6,4,318.0,15628.5
BANKNIFTY04OCT1825100CE_2018-10-03.csv,15,5,10,-1475.25,104474.25
BANKNIFTY04OCT1825100PE_2018-10-03.csv,13,5,8,-25.5,32262.0
BANKNIFTY04OCT1825200CE_2018-10-03.csv,10,2,8,-1244.25,50733.75
BANKNIFTY04OCT1825200PE_2018-10-03.csv,7,2,5,-214.5,24007.5
BANKNIFTY04OCT1825300CE_2018-10-03.csv,12,2,10,-790.5,48250.5
BANKNIFTY04OCT1825300PE_2018-10-03.csv,7,2,5,-214.5,34692.75
BANKNIFTY04OCT1825400CE_2018-10-03.csv,11,3,8,-348.0,26755.5
BANKNIFTY04OCT1825400PE_2018-10-03.csv,13,5,8,-434.25,86921.25
BANKNIFTY04OCT1825500CE_2018-10-03.csv,10,3,7,-192.75,16533.75
BANKNIFTY04OCT1825500PE_2018-10-03.csv,12,4,8,-735.0,105637.5
BANKNIFTY04OCT1825600CE_2018-10-03.csv,11,6,5,-48.0,9538.5
BANKNIFTY04OCT1825600PE_2018-10-03.csv,23,11,12,2346.0,242073.0
BANKNIFTY04OCT1825700CE_2018-10-03.csv,17,7,10,-75.0,8953.5
BANKNIFTY04OCT1825800CE_2018-10-03.csv,24,9,15,-96.75,7095.75
BANKNIFTY04OCT1824500CE_2018-10-04.csv,15,5,10,-374.25,102236.25
BANKNIFTY04OCT1824500PE_2018-10-04.csv,19,10,9,-21.0,3327.0
BANKNIFTY04OCT1824600CE_2018-10-04.csv,10,5,5,516.75,42138.75
BANKNIFTY04OCT1824600PE_2018-10-04.csv,13,7,6,-72.75,7131.0
BANKNIFTY04OCT1824700CE_2018-10-04.csv,10,2,8,-239.25,22252.5
BANKNIFTY04OCT1824700PE_2018-10-04.csv,17,9,8,-233.25,23445.0
BANKNIFTY04OCT1824800CE_2018-10-04.csv,6,2,4,-105.75,5481.75
BANKNIFTY04OCT1824800PE_2018-10-04.csv,17,9,8,399.75,59109.75
BANKNIFTY04OCT1824900CE_2018-10-04.csv,14,5,9,-162.75,5707.5
BANKNIFTY04OCT1824900PE_2018-10-04.csv,9,5,4,436.5,54858.0
BANKNIFTY04OCT1825000PE_2018-10-04.csv,9,3,6,-927.0,73831.5
BANKNIFTY04OCT1825100CE_2018-10-04.csv,31,11,20,-36.0,1910.25
BANKNIFTY04OCT1825100PE_2018-10-04.csv,13,4,9,-1644.75,134418.75
BANKNIFTY11OCT1823300PE_2018-10-05.csv,19,8,11,-78.0,11979.0
BANKNIFTY11OCT1823400PE_2018-10-05.csv,13,3,10,-236.25,10860.75
BANKNIFTY11OCT1823500PE_2018-10-05.csv,7,2,5,-40.5,6402.0
BANKNIFTY11OCT1823600PE_2018-10-05.csv,9,1,8,-267.75,10083.75
BANKNIFTY11OCT1823700PE_2018-10-05.csv,11,3,8,-227.25,16455.75
BANKNIFTY11OCT1823800PE_2018-10-05.csv,9,3,6,-80.25,16422.75
BANKNIFTY11OCT1823900PE_2018-10-05.csv,11,5,6,-6.75,26177.25
BANKNIFTY11OCT1824000PE_2018-10-05.csv,5,1,4,-278.25,14433.0
BANKNIFTY11OCT1824100PE_2018-10-05.csv,8,3,5,-177.0,25659.0
BANKNIFTY11OCT1824200PE_2018-10-05.csv,8,3,5,-186.0,30676.5
BANKNIFTY11OCT1824300PE_2018-10-05.csv,8,3,5,-294.0,39946.5
BANKNIFTY11OCT1824400PE_2018-10-05.csv,10,3,7,-476.25,56985.0
BANKNIFTY11OCT1824500PE_2018-10-05.csv,6,2,4,-83.25,45640.5
BANKNIFTY11OCT1824600PE_2018-10-05.csv,6,2,4,-165.0,51605.25
BANKNIFTY11OCT1824700PE_2018-10-05.csv,6,2,4,-186.0,56969.25
BANKNIFTY11OCT1824800CE_2018-10-05.csv,5,3,2,756.75,43944.0
BANKNIFTY11OCT1824900CE_2018-10-05.csv,6,3,3,348.75,46662.0
BANKNIFTY11OCT1825000CE_2018-10-05.csv,7,5,2,1413.0,48265.5
BANKNIFTY11OCT1825100CE_2018-10-05.csv,7,3,4,291.0,32461.5
BANKNIFTY11OCT1825200CE_2018-10-05.csv,9,5,4,698.25,34716.75
BANKNIFTY11OCT1825300CE_2018-10-05.csv,8,3,5,64.5,23526.0
BANKNIFTY11OCT1825400CE_2018-10-05.csv,6,2,4,-57.0,14630.25
BANKNIFTY11OCT1825500CE_2018-10-05.csv,10,4,6,-21.75,15777.75
BANKNIFTY11OCT1825600CE_2018-10-05.csv,12,3,9,-58.5,14647.5
BANKNIFTY11OCT1825700CE_2018-10-05.csv,11,6,5,154.5,11437.5
BANKNIFTY11OCT1825800CE_2018-10-05.csv,7,3,4,70.5,5645.25
BANKNIFTY11OCT1823300PE_2018-10-08.csv,20,9,11,109.5,15103.5
BANKNIFTY11OCT1823400PE_2018-10-08.csv,20,7,13,-39.75,18387.75
BANKNIFTY11OCT1823500PE_2018-10-08.csv,11,7,4,327.75,13883.25
BANKNIFTY11OCT1823600PE_2018-10-08.csv,15,6,9,-156.75,23664.75
BANKNIFTY11OCT1823700PE_2018-10-08.csv,16,6,10,-126.0,30840.0
BANKNIFTY11OCT1823800PE_2018-10-08.csv,11,5,6,135.75,25935.75
BANKNIFTY11OCT1823900PE_2018-10-08.csv,10,4,6,-150.75,28624.5
BANKNIFTY11OCT1824000PE_2018-10-08.csv,12,5,7,-38.25,41771.25
BANKNIFTY11OCT1824100PE_2018-10-08.csv,10,4,6,139.5,42121.5
BANKNIFTY11OCT1824200PE_2018-10-08.csv,11,2,9,-1103.25,56189.25
BANKNIFTY11OCT1824300CE_2018-10-08.csv,11,3,8,-1393.5,137627.25
BANKNIFTY11OCT1824300PE_2018-10-08.csv,15,6,9,-294.0,92335.5
BANKNIFTY11OCT1824400CE_2018-10-08.csv,9,2,7,-1292.25,89694.75
BANKNIFTY11OCT1824400PE_2018-10-08.csv,12,4,8,-659.25,88613.25
BANKNIFTY11OCT1824500CE_2018-10-08.csv,7,1,6,-1278.75,55763.25
BANKNIFTY11OCT1824500PE_2018-10-08.csv,11,5,6,-5.25,94536.75
BANKNIFTY11OCT1824600CE_2018-10-08.csv,6,1,5,-870.0,43890.0
BANKNIFTY11OCT1824600PE_2018-10-08.csv,15,5,10,-856.5,153421.5
BANKNIFTY11OCT1824700CE_2018-10-08.csv,8,4,4,315.75,49781.25
BANKNIFTY11OCT1824800CE_2018-10-08.csv,6,0,6,-1293.75,25434.75
BANKNIFTY11OCT1824900CE_2018-10-08.csv,11,3,8,-605.25,39900.75
BANKNIFTY11OCT1825000CE_2018-10-08.csv,6,1,5,-546.75,14676.75
BANKNIFTY11OCT1825100CE_2018-10-08.csv,8,2,6,-416.25,15195.75
BANKNIFTY11OCT1825200CE_2018-10-08.csv,12,3,9,-430.5,15043.5
BANKNIFTY11OCT1825300CE_2018-10-08.csv,9,3,6,-187.5,10699.5
BANKNIFTY11OCT1825400CE_2018-10-08.csv,11,5,6,87.0,10276.5
BANKNIFTY11OCT1825500CE_2018-10-08.csv,10,5,5,-11.25,5873.25
BANKNIFTY11OCT1823800PE_2018-10-09.csv,13,7,6,155.25,10799.25
BANKNIFTY11OCT1823900PE_2018-10-09.csv,12,7,5,163.5,13653.0
BANKNIFTY11OCT1824000PE_2018-10-09.csv,11,5,6,53.25,17441.25
BANKNIFTY11OCT1824100PE_2018-10-09.csv,7,2,5,-219.0,15045.75
BANKNIFTY11OCT1824200PE_2018-10-09.csv,9,3,6,-121.5,24196.5
BANKNIFTY11OCT1824300PE_2018-10-09.csv,9,3,6,-137.25,30869.25
BANKNIFTY11OCT1824400CE_2018-10-09.csv,14,5,9,-549.75,145985.25
BANKNIFTY11OCT1824400PE_2018-10-09.csv,9,3,6,-266.25,39377.25
BANKNIFTY11OCT1824500CE_2018-10-09.csv,9,4,5,152.25,75787.5
BANKNIFTY11OCT1824500PE_2018-10-09.csv,7,3,4,-176.25,38562.75
BANKNIFTY11OCT1824600CE_2018-10-09.csv,8,2,6,-1018.5,54033.0
BANKNIFTY11OCT1824600PE_2018-10-09.csv,7,3,4,-213.75,49046.25
BANKNIFTY11OCT1824700CE_2018-10-09.csv,10,4,6,-516.0,51757.5
BANKNIFTY11OCT1824700PE_2018-10-09.csv,9,4,5,51.75,75074.25
BANKNIFTY11OCT1824800CE_2018-10-09.csv,7,3,4,-19.5,28562.25
BANKNIFTY11OCT1824800PE_2018-10-09.csv,13,4,9,-915.75,130486.5
BANKNIFTY11OCT1824900CE_2018-10-09.csv,6,2,4,-159.0,16213.5
BANKNIFTY11OCT1825000CE_2018-10-09.csv,5,2,3,39.75,10343.25
BANKNIFTY11OCT1825100CE_2018-10-09.csv,12,4,8,19.5,16947.0
BANKNIFTY11OCT1825200CE_2018-10-09.csv,11,4,7,-32.25,10556.25
BANKNIFTY11OCT1825300CE_2018-10-09.csv,13,5,8,48.0,8333.25
BANKNIFTY11OCT1824000PE_2018-10-10.csv,16,5,11,-29.25,3828.75
BANKNIFTY11OCT1824100PE_2018-10-10.csv,16,5,11,-92.25,6020.25
BANKNIFTY11OCT1824200PE_2018-10-10.csv,15,3,12,-132.0,4590.0
BANKNIFTY11OCT1824300PE_2018-10-10.csv,13,4,9,-34.5,7398.75
BANKNIFTY11OCT1824400PE_2018-10-10.csv,13,5,8,-147.0,8239.5
BANKNIFTY11OCT1824500CE_2018-10-10.csv,12,9,3,5320.5,206487.0
BANKNIFTY11OCT1824500PE_2018-10-10.csv,12,3,9,-702.75,16400.25
BANKNIFTY11OCT1824600CE_2018-10-10.csv,12,8,4,4348.5,182439.75
BANKNIFTY11OCT1824600PE_2018-10-10.csv,13,3,10,-702.0,17662.5
BANKNIFTY11OCT1824700CE_2018-10-10.csv,16,8,8,1733.25,198386.25
BANKNIFTY11OCT1824700PE_2018-10-10.csv,8,2,6,-675.75,14490.75
BANKNIFTY11OCT1824800CE_2018-10-10.csv,9,5,4,1911.75,98509.5
BANKNIFTY11OCT1824800PE_2018-10-10.csv,8,1,7,-1110.75,31293.75
BANKNIFTY11OCT1824900CE_2018-10-10.csv,12,6,6,1140.0,101845.5
BANKNIFTY11OCT1824900PE_2018-10-10.csv,9,3,6,-1493.25,35198.25
BANKNIFTY11OCT1825000CE_2018-10-10.csv,11,6,5,693.75,65895.75
BANKNIFTY11OCT1825000PE_2018-10-10.csv,11,2,9,-1939.5,79824.0
BANKNIFTY11OCT1825100CE_2018-10-10.csv,7,2,5,45.75,33713.25
BANKNIFTY11OCT1825100PE_2018-10-10.csv,11,2,9,-3072.0,86000.25
BANKNIFTY11OCT1825200CE_2018-10-10.csv,12,7,5,654.75,29097.75
BANKNIFTY11OCT1825200PE_2018-10-10.csv,14,3,11,-3624.75,117464.25
BANKNIFTY11OCT1825300CE_2018-10-10.csv,11,7,4,672.0,15477.0
BANKNIFTY11OCT1825400CE_2018-10-10.csv,16,10,6,619.5,15416.25
BANKNIFTY11OCT1825500CE_2018-10-10.csv,17,10,7,139.5,9136.5
BANKNIFTY11OCT1823800PE_2018-10-11.csv,56,33,23,-5.25,1524.0
BANKNIFTY11OCT1824100PE_2018-10-11.csv,38,11,27,-53.25,2536.5
BANKNIFTY11OCT1824200PE_2018-10-11.csv,32,14,18,-69.0,4473.75
BANKNIFTY11OCT1824300PE_2018-10-11.csv,25,14,11,-159.75,3918.0
BANKNIFTY11OCT1824400CE_2018-10-11.csv,16,5,11,-1461.0,161833.5
BANKNIFTY11OCT1824400PE_2018-10-11.csv,21,8,13,-87.0,8889.75
BANKNIFTY11OCT1824500CE_2018-10-11.csv,11,5,6,310.5,88278.0
BANKNIFTY11OCT1824500PE_2018-10-11.csv,16,6,10,-219.0,13823.25
BANKNIFTY11OCT1824600CE_2018-10-11.csv,11,6,5,426.75,51003.75
BANKNIFTY11OCT1824600PE_2018-10-11.csv,16,6,10,-657.75,21745.5
BANKNIFTY11OCT1824700CE_2018-10-11.csv,11,5,6,237.75,36929.25
BANKNIFTY11OCT1824700PE_2018-10-11.csv,14,4,10,-1132.5,27638.25
BANKNIFTY11OCT1824800CE_2018-10-11.csv,9,6,3,317.25,15219.0
BANKNIFTY11OCT1824800PE_2018-10-11.csv,11,3,8,-1545.75,40970.25
BANKNIFTY11OCT1824900CE_2018-10-11.csv,16,6,10,-195.75,9102.0
BANKNIFTY11OCT1824900PE_2018-10-11.csv,9,3,6,-930.75,52880.25
BANKNIFTY11OCT1825000CE_2018-10-11.csv,23,10,13,5.25,3985.5
BANKNIFTY11OCT1825000PE_2018-10-11.csv,12,8,4,1653.75,102099.0
BANKNIFTY11OCT1825100PE_2018-10-11.csv,14,1,13,-4730.25,151272.75
BANKNIFTY11OCT1825200PE_2018-10-11.csv,14,4,10,-1900.5,187590.0
BANKNIFTY11OCT1825300PE_2018-10-11.csv,16,3,13,-4670.25,250045.5
BANKNIFTY17OCT1823500PE_2018-10-12.csv,12,3,9,-63.75,4586.25
BANKNIFTY17OCT1823700PE_2018-10-12.csv,13,3,10,-96.75,6056.25
BANKNIFTY17OCT1823800PE_2018-10-12.csv,15,6,9,-6.0,8565.0
BANKNIFTY17OCT1823900PE_2018-10-12.csv,15,5,10,-85.5,9591.0
BANKNIFTY17OCT1824000PE_2018-10-12.csv,10,5,5,20.25,8039.25
BANKNIFTY17OCT1824100PE_2018-10-12.csv,13,5,8,-27.0,12187.5
BANKNIFTY17OCT1824200PE_2018-10-12.csv,11,2,9,-348.75,12808.5
BANKNIFTY17OCT1824300PE_2018-10-12.csv,12,5,7,-31.5,16272.0
BANKNIFTY17OCT1824400PE_2018-10-12.csv,12,5,7,-90.0,19347.0
BANKNIFTY17OCT1824500PE_2018-10-12.csv,7,0,7,-509.25,13527.75
BANKNIFTY17OCT1824600PE_2018-10-12.csv,8,2,6,-329.25,19635.75
BANKNIFTY17OCT1824700PE_2018-10-12.csv,7,3,4,-168.0,20943.75
BANKNIFTY17OCT1824800PE_2018-10-12.csv,6,2,4,-213.0,21028.5
BANKNIFTY17OCT1824900PE_2018-10-12.csv,6,1,5,-395.25,24576.75
BANKNIFTY17OCT1825000CE_2018-10-12.csv,10,3,7,-493.5,160513.5
BANKNIFTY17OCT1825000PE_2018-10-12.csv,3,0,3,-518.25,14769.75
BANKNIFTY17OCT1825100CE_2018-10-12.csv,10,3,7,-975.0,127849.5
BANKNIFTY17OCT1825100PE_2018-10-12.csv,7,1,6,-701.25,39335.25
BANKNIFTY17OCT1825200CE_2018-10-12.csv,10,3,7,-948.0,110263.5
BANKNIFTY17OCT1825200PE_2018-10-12.csv,6,0,6,-1239.75,39885.75
BANKNIFTY17OCT1825300CE_2018-10-12.csv,10,4,6,68.25,96567.75
BANKNIFTY17OCT1825300PE_2018-10-12.csv,7,2,5,-462.75,56186.25
BANKNIFTY17OCT1825400CE_2018-10-12.csv,8,2,6,-783.75,64589.25
BANKNIFTY17OCT1825400PE_2018-10-12.csv,6,0,6,-2052.75,56351.25
BANKNIFTY17OCT1825500CE_2018-10-12.csv,7,1,6,-1134.0,45951.0
BANKNIFTY17OCT1825600CE_2018-10-12.csv,8,2,6,-447.0,46954.5
BANKNIFTY17OCT1825700CE_2018-10-12.csv,9,1,8,-1164.75,42482.25
BANKNIFTY17OCT1825800CE_2018-10-12.csv,8,2,6,-414.0,30519.0
BANKNIFTY17OCT1825900CE_2018-10-12.csv,10,5,5,162.75,27936.75
BANKNIFTY17OCT1826000CE_2018-10-12.csv,11,4,7,-205.5,24670.5
BANKNIFTY17OCT1826100CE_2018-10-12.csv,10,3,7,-205.5,19644.0
BANKNIFTY17OCT1826200CE_2018-10-12.csv,11,5,6,-11.25,14393.25
BANKNIFTY17OCT1826300CE_2018-10-12.csv,10,4,6,-95.25,11516.25
BANKNIFTY17OCT1826400CE_2018-10-12.csv,10,5,5,10.5,7894.5
BANKNIFTY17OCT1826500CE_2018-10-12.csv,13,4,9,-92.25,7598.25
BANKNIFTY17OCT1824100PE_2018-10-15.csv,13,6,7,14.25,4911.75
BANKNIFTY17OCT1824200PE_2018-10-15.csv,15,3,12,-181.5,7221.0
BANKNIFTY17OCT1824300PE_2018-10-15.csv,12,6,6,18.75,7748.25
BANKNIFTY17OCT1824400PE_2018-10-15.csv,14,6,8,-3.75,11907.75
BANKNIFTY17OCT1824500PE_2018-10-15.csv,9,3,6,-75.75,11157.75
BANKNIFTY17OCT1824600PE_2018-10-15.csv,13,5,8,-108.0,19764.0
BANKNIFTY17OCT1824700PE_2018-10-15.csv,8,3,5,-21.75,16038.75
BANKNIFTY17OCT1824800PE_2018-10-15.csv,9,4,5,91.5,23526.0
BANKNIFTY17OCT1824900PE_2018-10-15.csv,6,2,4,-126.0,19407.0
BANKNIFTY17OCT1825000PE_2018-10-15.csv,6,3,3,157.5,23134.5
BANKNIFTY17OCT1825100CE_2018-10-15.csv,9,5,4,1662.0,89152.5
BANKNIFTY17OCT1825100PE_2018-10-15.csv,9,4,5,-12.0,44875.5
BANKNIFTY17OCT1825200CE_2018-10-15.csv,7,5,2,1938.75,57308.25
BANKNIFTY17OCT1825200PE_2018-10-15.csv,6,3,3,189.0,35419.5
BANKNIFTY17OCT1825300CE_2018-10-15.csv,8,6,2,2064.75,54177.75
BANKNIFTY17OCT1825300PE_2018-10-15.csv,7,3,4,-160.5,59748.0
BANKNIFTY17OCT1825400CE_2018-10-15.csv,7,3,4,-42.75,35196.75
BANKNIFTY17OCT1825400PE_2018-10-15.csv,6,1,5,-1464.75,62156.25
BANKNIFTY17OCT1825500CE_2018-10-15.csv,9,6,3,870.75,35196.75
BANKNIFTY17OCT1825600CE_2018-10-15.csv,7,5,2,575.25,20234.25
BANKNIFTY17OCT1825700CE_2018-10-15.csv,10,6,4,468.75,21860.25
BANKNIFTY17OCT1825800CE_2018-10-15.csv,10,5,5,123.75,15735.75
BANKNIFTY17OCT1825900CE_2018-10-15.csv,6,3,3,114.0,7221.0
BANKNIFTY17OCT1826000CE_2018-10-15.csv,9,3,6,-83.25,7515.75
BANKNIFTY17OCT1826100CE_2018-10-15.csv,12,2,10,-180.0,7012.5
BANKNIFTY17OCT1826200CE_2018-10-15.csv,16,2,14,-199.5,6285.0
BANKNIFTY17OCT1824600PE_2018-10-16.csv,17,6,11,-5.25,3656.25
BANKNIFTY17OCT1824700PE_2018-10-16.csv,18,9,9,66.0,4963.5
BANKNIFTY17OCT1824800PE_2018-10-16.csv,13,6,7,9.75,4683.75
BANKNIFTY17OCT1824900PE_2018-10-16.csv,14,6,8,-11.25,7210.5
BANKNIFTY17OCT1825000PE_2018-10-16.csv,12,7,5,156.75,7212.75
BANKNIFTY17OCT1825100PE_2018-10-16.csv,14,6,8,55.5,12646.5
BANKNIFTY17OCT1825200CE_2018-10-16.csv,9,1,8,-2400.0,120491.25
BANKNIFTY17OCT1825200PE_2018-10-16.csv,10,4,6,-129.75,13083.75
BANKNIFTY17OCT1825300CE_2018-10-16.csv,10,1,9,-2493.0,104703.0
BANKNIFTY17OCT1825300PE_2018-10-16.csv,10,6,4,354.0,15841.5
BANKNIFTY17OCT1825400CE_2018-10-16.csv,9,1,8,-1905.0,75294.75
BANKNIFTY17OCT1825400PE_2018-10-16.csv,10,6,4,443.25,24011.25
BANKNIFTY17OCT1825500CE_2018-10-16.csv,7,1,6,-888.0,46911.75
BANKNIFTY17OCT1825500PE_2018-10-16.csv,10,5,5,248.25,32718.75
BANKNIFTY17OCT1825600CE_2018-10-16.csv,9,2,7,-685.5,43455.75
BANKNIFTY17OCT1825600PE_2018-10-16.csv,12,5,7,8.25,58664.25
BANKNIFTY17OCT1825700CE_2018-10-16.csv,6,0,6,-757.5,20988.0
BANKNIFTY17OCT1825700PE_2018-10-16.csv,14,6,8,-62.25,96878.25
BANKNIFTY17OCT1825800CE_2018-10-16.csv,6,3,3,109.5,13866.0
BANKNIFTY17OCT1825800PE_2018-10-16.csv,18,7,11,-1274.25,151466.25
BANKNIFTY17OCT1825900CE_2018-10-16.csv,16,8,8,195.0,24506.25
BANKNIFTY17OCT1826000CE_2018-10-16.csv,13,4,9,-127.5,11439.0
BANKNIFTY17OCT1826100CE_2018-10-16.csv,15,7,8,-30.0,8320.5
BANKNIFTY17OCT1825300CE_2018-10-17.csv,15,1,14,-4251.0,97659.75
BANKNIFTY17OCT1825400CE_2018-10-17.csv,14,3,11,-1919.25,88578.0
BANKNIFTY17OCT1825500CE_2018-10-17.csv,12,3,9,-1809.75,46116.0
BANKNIFTY17OCT1825500PE_2018-10-17.csv,12,4,8,-472.5,17884.5
BANKNIFTY17OCT1825600CE_2018-10-17.csv,14,5,9,-320.25,15225.0
BANKNIFTY17OCT1825600PE_2018-10-17.csv,9,3,6,42.0,29508.0
BANKNIFTY17OCT1825700CE_2018-10-17.csv,19,9,10,-159.75,4413.0
BANKNIFTY17OCT1825700PE_2018-10-17.csv,8,3,5,585.75,50661.0
BANKNIFTY17OCT1825800CE_2018-10-17.csv,29,16,13,-152.25,7392.75
BANKNIFTY17OCT1825800PE_2018-10-17.csv,13,8,5,2704.5,83938.5
BANKNIFTY17OCT1825900CE_2018-10-17.csv,30,14,16,-39.75,1614.0
BANKNIFTY17OCT1825900PE_2018-10-17.csv,13,5,8,1066.5,125342.25
BANKNIFTY17OCT1826000CE_2018-10-17.csv,45,21,24,-67.5,1640.25
BANKNIFTY17OCT1826000PE_2018-10-17.csv,14,9,5,4392.75,182208.0
BANKNIFTY17OCT1826100CE_2018-10-17.csv,58,42,16,6.75,1065.0
BANKNIFTY17OCT1826100PE_2018-10-17.csv,12,7,5,3530.25,180855.75
BANKNIFTY25OCT1823200PE_2018-10-19.csv,27,12,15,-33.0,11971.5
BANKNIFTY25OCT1823300PE_2018-10-19.csv,24,12,12,140.25,11973.75
BANKNIFTY25OCT1823400PE_2018-10-19.csv,21,10,11,97.5,11859.0
BANKNIFTY25OCT1823500PE_2018-10-19.csv,19,8,11,11.25,12462.75
BANKNIFTY25OCT1823600PE_2018-10-19.csv,22,6,16,-250.5,16684.5
BANKNIFTY25OCT1823700PE_2018-10-19.csv,22,9,13,129.0,20277.0
BANKNIFTY25OCT1823800PE_2018-10-19.csv,21,11,10,303.75,22464.75
BANKNIFTY25OCT1823900PE_2018-10-19.csv,23,12,11,111.75,29670.75
BANKNIFTY25OCT1824000PE_2018-10-19.csv,9,6,3,405.75,13773.75
BANKNIFTY25OCT1824100PE_2018-10-19.csv,21,11,10,633.0,39009.0
BANKNIFTY25OCT1824200PE_2018-10-19.csv,12,4,8,-16.5,27198.75
BANKNIFTY25OCT1824300PE_2018-10-19.csv,11,6,5,579.75,27171.75
BANKNIFTY25OCT1824400PE_2018-10-19.csv,11,6,5,635.25,32771.25
BANKNIFTY25OCT1824500PE_2018-10-19.csv,10,3,7,-451.5,35550.75
BANKNIFTY25OCT1824600PE_2018-10-19.csv,9,5,4,718.5,37503.0
BANKNIFTY25OCT1824700PE_2018-10-19.csv,7,3,4,105.0,33048.0
BANKNIFTY25OCT1824800PE_2018-10-19.csv,10,5,5,704.25,59319.0
BANKNIFTY25OCT1824900PE_2018-10-19.csv,8,4,4,649.5,56737.5
BANKNIFTY25OCT1825000CE_2018-10-19.csv,12,5,7,306.0,127165.5
BANKNIFTY25OCT1825000PE_2018-10-19.csv,8,5,3,1567.5,65185.5
BANKNIFTY25OCT1825100CE_2018-10-19.csv,9,3,6,-901.5,75745.5
BANKNIFTY25OCT1825100PE_2018-10-19.csv,8,4,4,853.5,73047.0
BANKNIFTY25OCT1825200CE_2018-10-19.csv,10,3,7,-435.0,69159.0
BANKNIFTY25OCT1825200PE_2018-10-19.csv,11,5,6,510.0,119629.5
BANKNIFTY25OCT1825300CE_2018-10-19.csv,10,3,7,-429.75,61099.5
BANKNIFTY25OCT1825300PE_2018-10-19.csv,15,7,8,1076.25,187593.75
BANKNIFTY25OCT1825400CE_2018-10-19.csv,11,6,5,694.5,54229.5
BANKNIFTY25OCT1825500CE_2018-10-19.csv,10,3,7,-330.75,36629.25
BANKNIFTY25OCT1825600CE_2018-10-19.csv,11,4,7,-197.25,31526.25
BANKNIFTY25OCT1825700CE_2018-10-19.csv,10,5,5,164.25,23823.75
BANKNIFTY25OCT1825800CE_2018-10-19.csv,15,6,9,-61.5,26371.5
BANKNIFTY25OCT1825900CE_2018-10-19.csv,17,12,5,480.0,23160.75
BANKNIFTY25OCT1826000CE_2018-10-19.csv,14,6,8,33.0,15328.5
BANKNIFTY25OCT1826100CE_2018-10-19.csv,18,11,7,271.5,15125.25
BANKNIFTY25OCT1826200CE_2018-10-19.csv,20,9,11,114.75,12391.5
BANKNIFTY25OCT1824000PE_2018-10-22.csv,10,5,5,90.0,5115.0
BANKNIFTY25OCT1824100PE_2018-10-22.csv,15,6,9,30.0,9567.0
BANKNIFTY25OCT1824200PE_2018-10-22.csv,13,4,9,-132.0,9010.5
BANKNIFTY25OCT1824300PE_2018-10-22.csv,13,5,8,-119.25,12541.5
BANKNIFTY25OCT1824400PE_2018-10-22.csv,10,4,6,-133.5,12237.75
BANKNIFTY25OCT1824500PE_2018-10-22.csv,8,4,4,57.0,12363.0
BANKNIFTY25OCT1824600PE_2018-10-22.csv,9,4,5,81.0,16599.75
BANKNIFTY25OCT1824700PE_2018-10-22.csv,9,3,6,-144.75,18651.75
BANKNIFTY25OCT1824800PE_2018-10-22.csv,8,3,5,50.25,23974.5
BANKNIFTY25OCT1824900PE_2018-10-22.csv,10,4,6,298.5,36334.5
BANKNIFTY25OCT1825000PE_2018-10-22.csv,9,4,5,29.25,40872.0
BANKNIFTY25OCT1825100CE_2018-10-22.csv,11,3,8,-1245.0,104055.0
BANKNIFTY25OCT1825100PE_2018-10-22.csv,4,1,3,-544.5,26463.0
BANKNIFTY25OCT1825200CE_2018-10-22.csv,11,3,8,-531.0,86110.5
BANKNIFTY25OCT1825200PE_2018-10-22.csv,10,5,5,1113.75,72306.75
BANKNIFTY25OCT1825300CE_2018-10-22.csv,11,3,8,-602.25,69992.25
BANKNIFTY25OCT1825300PE_2018-10-22.csv,10,5,5,1068.0,91592.25
BANKNIFTY25OCT1825400CE_2018-10-22.csv,12,5,7,173.25,58400.25
BANKNIFTY25OCT1825400PE_2018-10-22.csv,14,3,11,-1424.25,132240.75
BANKNIFTY25OCT1825500CE_2018-10-22.csv,10,5,5,312.75,36342.75
BANKNIFTY25OCT1825500PE_2018-10-22.csv,13,5,8,266.25,148038.75
BANKNIFTY25OCT1825600CE_2018-10-22.csv,11,6,5,453.75,33524.25
BANKNIFTY25OCT1825700CE_2018-10-22.csv,16,5,11,-89.25,31577.25
BANKNIFTY25OCT1825800CE_2018-10-22.csv,14,5,9,13.5,20655.0
BANKNIFTY25OCT1825900CE_2018-10-22.csv,12,4,8,9.75,13175.25
BANKNIFTY25OCT1826000CE_2018-10-22.csv,13,6,7,101.25,9509.25
BANKNIFTY25OCT1826100CE_2018-10-22.csv,17,7,10,27.75,9473.25
BANKNIFTY25OCT1826200CE_2018-10-22.csv,14,4,10,-37.5,5538.0
BANKNIFTY25OCT1826300CE_2018-10-22.csv,18,9,9,44.25,5591.25
BANKNIFTY25OCT1824000PE_2018-10-23.csv,10,6,4,102.0,7056.0
BANKNIFTY25OCT1824100PE_2018-10-23.csv,13,4,9,-122.25,10968.75
BANKNIFTY25OCT1824200PE_2018-10-23.csv,7,3,4,9.75,7427.25
BANKNIFTY25OCT1824300PE_2018-10-23.csv,7,3,4,-24.75,9975.75
BANKNIFTY25OCT1824400PE_2018-10-23.csv,7,2,5,-149.25,12487.5
BANKNIFTY25OCT1824500PE_2018-10-23.csv,7,3,4,136.5,15405.0
BANKNIFTY25OCT1824600PE_2018-10-23.csv,6,3,3,162.0,17583.0
BANKNIFTY25OCT1824700CE_2018-10-23.csv,16,6,10,668.25,166104.75
BANKNIFTY25OCT1824700PE_2018-10-23.csv,10,6,4,822.0,38680.5
BANKNIFTY25OCT1824800CE_2018-10-23.csv,12,3,9,-1099.5,102403.5
BANKNIFTY25OCT1824800PE_2018-10-23.csv,5,1,4,-214.5,23142.0
BANKNIFTY25OCT1824900CE_2018-10-23.csv,9,2,7,-556.5,58971.0
BANKNIFTY25OCT1824900PE_2018-10-23.csv,8,4,4,504.0,46806.0
BANKNIFTY25OCT1825000CE_2018-10-23.csv,7,3,4,156.0,36349.5
BANKNIFTY25OCT1825000PE_2018-10-23.csv,7,3,4,50.25,50882.25
BANKNIFTY25OCT1825100CE_2018-10-23.csv,7,1,6,-512.25,27701.25
BANKNIFTY25OCT1825100PE_2018-10-23.csv,11,5,6,444.75,102713.25
BANKNIFTY25OCT1825200CE_2018-10-23.csv,5,1,4,-179.25,14361.75
BANKNIFTY25OCT1825200PE_2018-10-23.csv,12,5,7,-332.25,136701.0
BANKNIFTY25OCT1825300CE_2018-10-23.csv,9,4,5,288.75,20087.25
BANKNIFTY25OCT1825400CE_2018-10-23.csv,8,2,6,-65.25,13953.75
BANKNIFTY25OCT1825500CE_2018-10-23.csv,10,3,7,-42.0,12324.0
BANKNIFTY25OCT1825600CE_2018-10-23.csv,11,5,6,45.75,9158.25
BANKNIFTY25OCT1825700CE_2018-10-23.csv,9,3,6,-26.25,5804.25
BANKNIFTY25OCT1824500PE_2018-10-24.csv,18,11,7,289.5,13678.5
BANKNIFTY25OCT1824600PE_2018-10-24.csv,12,5,7,-83.25,14615.25
BANKNIFTY25OCT1824700PE_2018-10-24.csv,12,5,7,-101.25,16407.75
BANKNIFTY25OCT1824800PE_2018-10-24.csv,11,5,6,-177.0,19215.0
BANKNIFTY25OCT1824900CE_2018-10-24.csv,14,5,9,-103.5,114508.5
BANKNIFTY25OCT1824900PE_2018-10-24.csv,13,6,7,-105.0,30769.5
BANKNIFTY25OCT1825000CE_2018-10-24.csv,8,0,8,-1986.0,55185.0
BANKNIFTY25OCT1825000PE_2018-10-24.csv,11,5,6,180.75,33176.25
BANKNIFTY25OCT1825100CE_2018-10-24.csv,11,3,8,-602.25,58972.5
BANKNIFTY25OCT1825100PE_2018-10-24.csv,12,6,6,-75.0,56262.75
BANKNIFTY25OCT1825200CE_2018-10-24.csv,13,3,10,-768.0,48319.5
BANKNIFTY25OCT1825200PE_2018-10-24.csv,12,5,7,-60.0,75348.0
BANKNIFTY25OCT1825300CE_2018-10-24.csv,11,2,9,-700.5,29751.0
BANKNIFTY25OCT1825300PE_2018-10-24.csv,12,5,7,-76.5,102789.0
BANKNIFTY25OCT1825400CE_2018-10-24.csv,15,3,12,-418.5,25323.0
BANKNIFTY25OCT1825400PE_2018-10-24.csv,16,7,9,112.5,178511.25
BANKNIFTY25OCT1825500CE_2018-10-24.csv,14,3,11,-309.75,15152.25
BANKNIFTY25OCT1825500PE_2018-10-24.csv,17,8,9,1097.25,212031.75
BANKNIFTY25OCT1825600CE_2018-10-24.csv,16,5,11,-105.0,11170.5
BANKNIFTY25OCT1825700CE_2018-10-24.csv,17,8,9,27.0,7152.0
BANKNIFTY25OCT1825800CE_2018-10-24.csv,24,9,15,-66.0,6657.0
BANKNIFTY25OCT1824500CE_2018-10-25.csv,18,4,14,-2727.0,164995.5
BANKNIFTY25OCT1824500PE_2018-10-25.csv,13,6,7,-19.5,3837.75
BANKNIFTY25OCT1824600CE_2018-10-25.csv,16,6,10,-293.25,111249.75
BANKNIFTY25OCT1824600PE_2018-10-25.csv,10,3,7,-177.0,3597.75
BANKNIFTY25OCT1824700CE_2018-10-25.csv,13,6,7,-234.0,60186.0
BANKNIFTY25OCT1824700PE_2018-10-25.csv,9,1,8,-447.0,9255.75
BANKNIFTY25OCT1824800CE_2018-10-25.csv,7,2,5,-448.5,22206.0
BANKNIFTY25OCT1824800PE_2018-10-25.csv,7,1,6,-966.0,13220.25
BANKNIFTY25OCT1824900CE_2018-10-25.csv,13,6,7,-238.5,19586.25
BANKNIFTY25OCT1824900PE_2018-10-25.csv,4,2,2,-475.5,16693.5
BANKNIFTY25OCT1825000CE_2018-10-25.csv,14,6,8,99.75,12919.5
BANKNIFTY25OCT1825000PE_2018-10-25.csv,8,3,5,-774.75,49136.25
BANKNIFTY25OCT1825100CE_2018-10-25.csv,13,6,7,-87.0,7119.75
BANKNIFTY25OCT1825100PE_2018-10-25.csv,13,5,8,-1293.0,111742.5
BANKNIFTY25OCT1825200CE_2018-10-25.csv,19,10,9,11.25,3063.0
BANKNIFTY25OCT1825200PE_2018-10-25.csv,15,5,10,-1876.5,179629.5
BANKNIFTY01NOV1823400PE_2018-10-26.csv,17,5,12,-88.5,10911.0
BANKNIFTY01NOV1823500PE_2018-10-26.csv,13,3,10,-60.75,9810.75
BANKNIFTY01NOV1823600PE_2018-10-26.csv,14,5,9,-46.5,13924.5
BANKNIFTY01NOV1823700PE_2018-10-26.csv,15,5,10,48.0,19281.75
BANKNIFTY01NOV1823800PE_2018-10-26.csv,13,4,9,-75.0,18733.5
BANKNIFTY01NOV1823900PE_2018-10-26.csv,10,3,7,-84.75,18326.25
BANKNIFTY01NOV1824000PE_2018-10-26.csv,10,4,6,258.75,24534.75
BANKNIFTY01NOV1824100PE_2018-10-26.csv,10,2,8,-268.5,28935.0
BANKNIFTY01NOV1824200PE_2018-10-26.csv,10,3,7,-184.5,34798.5
BANKNIFTY01NOV1824300PE_2018-10-26.csv,9,2,7,-421.5,38580.0
BANKNIFTY01NOV1824400PE_2018-10-26.csv,9,4,5,194.25,51006.0
BANKNIFTY01NOV1824500PE_2018-10-26.csv,4,0,4,-730.5,25608.0
BANKNIFTY01NOV1824600CE_2018-10-26.csv,8,3,5,129.75,76091.25
BANKNIFTY01NOV1824600PE_2018-10-26.csv,8,2,6,-456.75,60159.75
BANKNIFTY01NOV1824700CE_2018-10-26.csv,10,4,6,97.5,76812.0
BANKNIFTY01NOV1824700PE_2018-10-26.csv,7,2,5,-329.25,69071.25
BANKNIFTY01NOV1824800CE_2018-10-26.csv,6,2,4,-303.0,36516.0
BANKNIFTY01NOV1824800PE_2018-10-26.csv,9,5,4,2086.5,97327.5
BANKNIFTY01NOV1824900CE_2018-10-26.csv,7,3,4,181.5,37075.5
BANKNIFTY01NOV1824900PE_2018-10-26.csv,8,3,5,414.0,106077.75
BANKNIFTY01NOV1825000CE_2018-10-26.csv,5,1,4,-264.0,21900.0
BANKNIFTY01NOV1825100CE_2018-10-26.csv,6,3,3,297.75,17688.75
BANKNIFTY01NOV1825200CE_2018-10-26.csv,7,4,3,351.75,16835.25
BANKNIFTY01NOV1825300CE_2018-10-26.csv,8,3,5,36.75,13752.75
BANKNIFTY01NOV1825400CE_2018-10-26.csv,10,4,6,87.75,13856.25
BANKNIFTY01NOV1825500CE_2018-10-26.csv,11,5,6,78.0,10287.0
BANKNIFTY01NOV1825600CE_2018-10-26.csv,12,4,8,-57.75,7767.75
BANKNIFTY01NOV1825700CE_2018-10-26.csv,14,4,10,-52.5,6765.0
BANKNIFTY01NOV1823500PE_2018-10-29.csv,13,0,13,-213.0,5757.0
BANKNIFTY01NOV1823600PE_2018-10-29.csv,16,3,13,-208.5,8358.0
BANKNIFTY01NOV1823700PE_2018-10-29.csv,10,1,9,-247.5,7833.0
BANKNIFTY01NOV1823800PE_2018-10-29.csv,11,1,10,-303.0,9273.0
BANKNIFTY01NOV1823900PE_2018-10-29.csv,9,2,7,-270.75,10601.25
BANKNIFTY01NOV1824000PE_2018-10-29.csv,10,2,8,-387.0,18216.0
BANKNIFTY01NOV1824100PE_2018-10-29.csv,10,2,8,-450.0,20856.0
BANKNIFTY01NOV1824200PE_2018-10-29.csv,9,1,8,-742.5,23896.5
BANKNIFTY01NOV1824300PE_2018-10-29.csv,7,2,5,-339.0,19347.0
BANKNIFTY01NOV1824400CE_2018-10-29.csv,12,8,4,3969.0,158860.5
BANKNIFTY01NOV1824400PE_2018-10-29.csv,7,2,5,-298.5,23623.5
BANKNIFTY01NOV1824500CE_2018-10-29.csv,10,6,4,1772.25,101444.25
BANKNIFTY01NOV1824500PE_2018-10-29.csv,9,3,6,-45.75,44663.25
BANKNIFTY01NOV1824600CE_2018-10-29.csv,7,5,2,1542.0,67618.5
BANKNIFTY01NOV1824600PE_2018-10-29.csv,10,2,8,-903.0,65869.5
BANKNIFTY01NOV1824700CE_2018-10-29.csv,8,6,2,1794.75,64065.75
BANKNIFTY01NOV1824700PE_2018-10-29.csv,10,0,10,-2850.75,85178.25
BANKNIFTY01NOV1824800CE_2018-10-29.csv,5,3,2,780.75,36522.75
BANKNIFTY01NOV1824800PE_2018-10-29.csv,10,1,9,-2545.5,102156.0
BANKNIFTY01NOV1824900CE_2018-10-29.csv,10,6,4,631.5,49612.5
BANKNIFTY01NOV1824900PE_2018-10-29.csv,15,3,12,-2997.0,165690.0
BANKNIFTY01NOV1825000CE_2018-10-29.csv,7,5,2,553.5,22456.5
BANKNIFTY01NOV1825100CE_2018-10-29.csv,9,5,4,463.5,20593.5
BANKNIFTY01NOV1825200CE_2018-10-29.csv,11,6,5,343.5,21533.25
BANKNIFTY01NOV1825300CE_2018-10-29.csv,10,8,2,634.5,12957.0
BANKNIFTY01NOV1824100PE_2018-10-30.csv,16,8,8,34.5,9258.0
BANKNIFTY01NOV1824200PE_2018-10-30.csv,13,4,9,-231.75,10092.75
BANKNIFTY01NOV1824300PE_2018-10-30.csv,16,8,8,107.25,16871.25
BANKNIFTY01NOV1824400PE_2018-10-30.csv,15,6,9,-65.25,21473.25
BANKNIFTY01NOV1824500PE_2018-10-30.csv,15,6,9,-38.25,27810.75
BANKNIFTY01NOV1824600PE_2018-10-30.csv,13,5,8,-245.25,30786.75
BANKNIFTY01NOV1824700CE_2018-10-30.csv,15,6,9,-23.25,167323.5
BANKNIFTY01NOV1824700PE_2018-10-30.csv,12,4,8,-6.0,42004.5
BANKNIFTY01NOV1824800CE_2018-10-30.csv,8,2,6,-1263.75,76803.75
BANKNIFTY01NOV1824800PE_2018-10-30.csv,11,3,8,-596.25,47193.75
BANKNIFTY01NOV1824900CE_2018-10-30.csv,10,4,6,-154.5,77055.75
BANKNIFTY01NOV1824900PE_2018-10-30.csv,9,3,6,-297.75,53815.5
BANKNIFTY01NOV1825000CE_2018-10-30.csv,8,5,3,938.25,47475.0
BANKNIFTY01NOV1825000PE_2018-10-30.csv,8,2,6,-675.75,54884.25
BANKNIFTY01NOV1825100CE_2018-10-30.csv,10,4,6,189.0,43300.5
BANKNIFTY01NOV1825100PE_2018-10-30.csv,10,3,7,-729.75,87312.0
BANKNIFTY01NOV1825200CE_2018-10-30.csv,10,3,7,6.0,31887.0
BANKNIFTY01NOV1825200PE_2018-10-30.csv,17,7,10,811.5,180921.0
BANKNIFTY01NOV1825300CE_2018-10-30.csv,12,4,8,34.5,26310.0
BANKNIFTY01NOV1825300PE_2018-10-30.csv,17,6,11,564.0,223488.75
BANKNIFTY01NOV1825400CE_2018-10-30.csv,15,6,9,123.0,23379.0
BANKNIFTY01NOV1825500CE_2018-10-30.csv,14,5,9,18.0,15810.0
BANKNIFTY01NOV1825600CE_2018-10-30.csv,18,9,9,273.75,15075.75
BANKNIFTY01NOV1825700CE_2018-10-30.csv,20,10,10,151.5,10252.5
BANKNIFTY01NOV1823900PE_2018-10-31.csv,21,4,17,-113.25,6522.75
BANKNIFTY01NOV1824000PE_2018-10-31.csv,13,3,10,-121.5,6361.5
BANKNIFTY01NOV1824100PE_2018-10-31.csv,13,4,9,-45.75,8312.25
BANKNIFTY01NOV1824200PE_2018-10-31.csv,7,2,5,-150.0,7342.5
BANKNIFTY01NOV1824300PE_2018-10-31.csv,5,2,3,-219.0,6837.0
BANKNIFTY01NOV1824400CE_2018-10-31.csv,21,12,9,4847.25,294979.5
BANKNIFTY01NOV1824400PE_2018-10-31.csv,8,3,5,-124.5,16900.5
BANKNIFTY01NOV1824500CE_2018-10-31.csv,14,8,6,2787.0,169732.5
BANKNIFTY01NOV1824500PE_2018-10-31.csv,9,2,7,-215.25,20244.75
BANKNIFTY01NOV1824600CE_2018-10-31.csv,10,5,5,1338.75,105606.0
BANKNIFTY01NOV1824600PE_2018-10-31.csv,9,3,6,105.75,29963.25
BANKNIFTY01NOV1824700CE_2018-10-31.csv,7,4,3,1078.5,58288.5
BANKNIFTY01NOV1824700PE_2018-10-31.csv,6,2,4,-76.5,30607.5
BANKNIFTY01NOV1824800CE_2018-10-31.csv,7,5,2,1059.75,43988.25
BANKNIFTY01NOV1824800PE_2018-10-31.csv,6,2,4,-576.0,37102.5
BANKNIFTY01NOV1824900CE_2018-10-31.csv,8,5,3,115.5,35080.5
BANKNIFTY01NOV1824900PE_2018-10-31.csv,9,3,6,-744.0,70869.0
BANKNIFTY01NOV1825000CE_2018-10-31.csv,10,6,4,573.0,36165.0
BANKNIFTY01NOV1825000PE_2018-10-31.csv,7,2,5,-426.0,67665.0
BANKNIFTY01NOV1825100CE_2018-10-31.csv,12,8,4,409.5,25149.0
BANKNIFTY01NOV1825200CE_2018-10-31.csv,10,6,4,291.75,15995.25
BANKNIFTY01NOV1825300CE_2018-10-31.csv,10,6,4,168.0,9693.0
BANKNIFTY01NOV1825400CE_2018-10-31.csv,13,7,6,43.5,8599.5
BANKNIFTY01NOV1824800CE_2018-11-01.csv,17,9,8,2460.0,217212.75
BANKNIFTY01NOV1824900CE_2018-11-01.csv,19,7,12,-1002.75,192771.75
BANKNIFTY01NOV1825000CE_2018-11-01.csv,13,6,7,-130.5,92470.5
BANKNIFTY01NOV1825000PE_2018-11-01.csv,24,11,13,59.25,6922.5
BANKNIFTY01NOV1825100CE_2018-11-01.csv,13,7,6,582.0,67812.0
BANKNIFTY01NOV1825100PE_2018-11-01.csv,17,10,7,198.0,10017.75
BANKNIFTY01NOV1825200CE_2018-11-01.csv,15,5,10,-210.75,48512.25
BANKNIFTY01NOV1825200PE_2018-11-01.csv,20,12,8,594.75,19848.0
BANKNIFTY01NOV1825300CE_2018-11-01.csv,15,7,8,256.5,20839.5
BANKNIFTY01NOV1825300PE_2018-11-01.csv,15,6,9,-119.25,41037.0
BANKNIFTY01NOV1825400CE_2018-11-01.csv,19,8,11,-129.75,8104.5
BANKNIFTY01NOV1825400PE_2018-11-01.csv,14,3,11,-1500.75,65108.25
BANKNIFTY01NOV1825500PE_2018-11-01.csv,12,2,10,-1649.25,92292.75
BANKNIFTY01NOV1825600PE_2018-11-01.csv,24,10,14,1513.5,237858.75
BANKNIFTY06NOV1824800PE_2018-11-02.csv,11,3,8,-22.5,4833.0
BANKNIFTY06NOV1824900PE_2018-11-02.csv,12,4,8,-40.5,6598.5
BANKNIFTY06NOV1825000PE_2018-11-02.csv,12,1,11,-275.25,9126.75
BANKNIFTY06NOV1825100PE_2018-11-02.csv,9,1,8,-255.75,8784.75
BANKNIFTY06NOV1825200PE_2018-11-02.csv,12,4,8,-150.75,16512.75
BANKNIFTY06NOV1825300CE_2018-11-02.csv,8,2,6,-1013.25,116544.75
BANKNIFTY06NOV1825300PE_2018-11-02.csv,11,2,9,-351.75,20180.25
BANKNIFTY06NOV1825400CE_2018-11-02.csv,7,2,5,-811.5,84464.25
BANKNIFTY06NOV1825400PE_2018-11-02.csv,10,4,6,-132.0,27099.75
BANKNIFTY06NOV1825500CE_2018-11-02.csv,7,2,5,-657.75,66414.75
BANKNIFTY06NOV1825500PE_2018-11-02.csv,9,4,5,30.0,33129.0
BANKNIFTY06NOV1825600CE_2018-11-02.csv,7,3,4,291.75,51870.75
BANKNIFTY06NOV1825600PE_2018-11-02.csv,10,3,7,-348.0,43578.0
BANKNIFTY06NOV1825700CE_2018-11-02.csv,7,3,4,0.0,40282.5
BANKNIFTY06NOV1825700PE_2018-11-02.csv,6,0,6,-1332.75,38920.5
BANKNIFTY06NOV1825800CE_2018-11-02.csv,5,3,2,357.75,22950.75
BANKNIFTY06NOV1825800PE_2018-11-02.csv,13,2,11,-1839.0,100949.25
BANKNIFTY06NOV1825900CE_2018-11-02.csv,8,3,5,-232.5,26314.5
BANKNIFTY06NOV1825900PE_2018-11-02.csv,16,2,14,-3399.75,153597.0
BANKNIFTY06NOV1826000CE_2018-11-02.csv,7,2,5,-237.0,16476.0
BANKNIFTY06NOV1826100CE_2018-11-02.csv,9,3,6,-180.75,13578.75
BANKNIFTY06NOV1826200CE_2018-11-02.csv,11,5,6,25.5,13327.5
BANKNIFTY06NOV1826300CE_2018-11-02.csv,11,3,8,-39.0,7312.5
BANKNIFTY06NOV1825100PE_2018-11-05.csv,9,2,7,-15.0,2917.5
BANKNIFTY06NOV1825200PE_2018-11-05.csv,16,6,10,-6.75,7745.25
BANKNIFTY06NOV1825300CE_2018-11-05.csv,13,5,8,209.25,144576.0
BANKNIFTY06NOV1825300PE_2018-11-05.csv,15,6,9,26.25,11979.75
BANKNIFTY06NOV1825400CE_2018-11-05.csv,13,5,8,-226.5,115341.75
BANKNIFTY06NOV1825400PE_2018-11-05.csv,13,5,8,131.25,18275.25
BANKNIFTY06NOV1825500CE_2018-11-05.csv,8,3,5,-303.75,52377.75
BANKNIFTY06NOV1825500PE_2018-11-05.csv,13,6,7,80.25,30261.75
BANKNIFTY06NOV1825600CE_2018-11-05.csv,8,4,4,378.75,42321.75
BANKNIFTY06NOV1825600PE_2018-11-05.csv,8,2,6,-505.5,24072.0
BANKNIFTY06NOV1825700CE_2018-11-05.csv,11,6,5,332.25,34176.75
BANKNIFTY06NOV1825700PE_2018-11-05.csv,11,3,8,-1397.25,50754.75
BANKNIFTY06NOV1825800CE_2018-11-05.csv,9,3,6,-181.5,21573.0
BANKNIFTY06NOV1825800PE_2018-11-05.csv,12,4,8,-921.0,78090.0
BANKNIFTY06NOV1825900CE_2018-11-05.csv,10,5,5,158.25,12942.75
BANKNIFTY06NOV1825900PE_2018-11-05.csv,17,5,12,-1452.0,145666.5
BANKNIFTY06NOV1826000CE_2018-11-05.csv,12,4,8,-60.0,9597.75
BANKNIFTY06NOV1826100CE_2018-11-05.csv,16,5,11,-76.5,6381.0
BANKNIFTY06NOV1825400CE_2018-11-06.csv,13,5,8,-435.0,109477.5
BANKNIFTY06NOV1825500CE_2018-11-06.csv,8,2,6,-983.25,59208.75
BANKNIFTY06NOV1825600CE_2018-11-06.csv,10,3,7,-1016.25,44499.0
BANKNIFTY06NOV1825700CE_2018-11-06.csv,14,5,9,-484.5,30851.25
BANKNIFTY06NOV1825700PE_2018-11-06.csv,13,3,10,-324.75,11597.25
BANKNIFTY06NOV1825800CE_2018-11-06.csv,15,3,12,-289.5,11487.75
BANKNIFTY06NOV1825800PE_2018-11-06.csv,10,3,7,-303.0,23121.0
BANKNIFTY06NOV1825900CE_2018-11-06.csv,23,10,13,45.0,5324.25
BANKNIFTY06NOV1825900PE_2018-11-06.csv,11,4,7,501.75,52182.0
BANKNIFTY06NOV1826000PE_2018-11-06.csv,8,3,5,226.5,59867.25
BANKNIFTY06NOV1826100PE_2018-11-06.csv,13,7,6,2211.0,142819.5
BANKNIFTY15NOV1824900PE_2018-11-09.csv,12,5,7,3.75,7326.75
BANKNIFTY15NOV1825000PE_2018-11-09.csv,12,5,7,63.75,10130.25
BANKNIFTY15NOV1825100PE_2018-11-09.csv,12,6,6,196.5,14145.0
BANKNIFTY15NOV1825200PE_2018-11-09.csv,6,3,3,105.75,10229.25
BANKNIFTY15NOV1825300PE_2018-11-09.csv,7,2,5,-103.5,15420.75
BANKNIFTY15NOV1825400PE_2018-11-09.csv,5,3,2,240.0,15753.0
BANKNIFTY15NOV1825500CE_2018-11-09.csv,6,3,3,379.5,67465.5
BANKNIFTY15NOV1825500PE_2018-11-09.csv,7,2,5,-186.75,26540.25
BANKNIFTY15NOV1825600CE_2018-11-09.csv,9,4,5,477.0,78579.0
BANKNIFTY15NOV1825600PE_2018-11-09.csv,6,1,5,-513.75,28580.25
BANKNIFTY15NOV1825700CE_2018-11-09.csv,8,4,4,732.0,55840.5
BANKNIFTY15NOV1825700PE_2018-11-09.csv,7,2,5,-486.75,41442.75
BANKNIFTY15NOV1825800CE_2018-11-09.csv,7,4,3,616.5,37771.5
BANKNIFTY15NOV1825800PE_2018-11-09.csv,5,2,3,10.5,40014.0
BANKNIFTY15NOV1825900CE_2018-11-09.csv,8,4,4,327.0,32140.5
BANKNIFTY15NOV1825900PE_2018-11-09.csv,6,2,4,-86.25,57947.25
BANKNIFTY15NOV1826000CE_2018-11-09.csv,10,5,5,279.75,28503.75
BANKNIFTY15NOV1826100CE_2018-11-09.csv,9,5,4,283.5,19041.0
BANKNIFTY15NOV1826200CE_2018-11-09.csv,10,7,3,423.0,12915.0
BANKNIFTY15NOV1826300CE_2018-11-09.csv,12,5,7,32.25,11102.25
BANKNIFTY15NOV1825200PE_2018-11-12.csv,11,5,6,54.75,11021.25
BANKNIFTY15NOV1825300PE_2018-11-12.csv,14,6,8,135.75,22044.0
BANKNIFTY15NOV1825400CE_2018-11-12.csv,10,2,8,-1625.25,104070.75
BANKNIFTY15NOV1825400PE_2018-11-12.csv,11,5,6,70.5,23079.0
BANKNIFTY15NOV1825500CE_2018-11-12.csv,6,1,5,-971.25,53402.25
BANKNIFTY15NOV1825500PE_2018-11-12.csv,12,5,7,234.75,38514.75
BANKNIFTY15NOV1825600CE_2018-11-12.csv,10,1,9,-1961.25,70566.75
BANKNIFTY15NOV1825600PE_2018-11-12.csv,5,4,1,994.5,22446.0
BANKNIFTY15NOV1825700CE_2018-11-12.csv,7,2,5,-641.25,40212.75
BANKNIFTY15NOV1825700PE_2018-11-12.csv,7,5,2,1296.0,45073.5
BANKNIFTY15NOV1825800CE_2018-11-12.csv,8,3,5,-165.0,33171.0
BANKNIFTY15NOV1825800PE_2018-11-12.csv,6,3,3,497.25,50694.0
BANKNIFTY15NOV1825900CE_2018-11-12.csv,8,2,6,-427.5,22834.5
BANKNIFTY15NOV1825900PE_2018-11-12.csv,6,5,1,2217.75,62398.5
BANKNIFTY15NOV1826000CE_2018-11-12.csv,6,0,6,-584.25,13476.75
BANKNIFTY15NOV1826000PE_2018-11-12.csv,6,5,1,2616.0,75390.75
BANKNIFTY15NOV1826100CE_2018-11-12.csv,6,2,4,-243.0,8584.5
BANKNIFTY15NOV1826200CE_2018-11-12.csv,11,2,9,-257.25,10497.75
BANKNIFTY15NOV1826300CE_2018-11-12.csv,8,2,6,-78.75,4820.25
BANKNIFTY15NOV1824900PE_2018-11-13.csv,12,4,8,-18.75,7044.0
BANKNIFTY15NOV1825000PE_2018-11-13.csv,14,5,9,-93.0,9795.0
BANKNIFTY15NOV1825100PE_2018-11-13.csv,13,4,9,-78.75,13569.75
BANKNIFTY15NOV1825200CE_2018-11-13.csv,14,8,6,3064.5,166567.5
BANKNIFTY15NOV1825200PE_2018-11-13.csv,10,5,5,-27.75,12237.75
BANKNIFTY15NOV1825300CE_2018-11-13.csv,9,3,6,-15.0,87628.5
BANKNIFTY15NOV1825300PE_2018-11-13.csv,11,5,6,182.25,26404.5
BANKNIFTY15NOV1825400CE_2018-11-13.csv,10,7,3,1986.0,79156.5
BANKNIFTY15NOV1825400PE_2018-11-13.csv,9,3,6,-126.75,32550.75
BANKNIFTY15NOV1825500CE_2018-11-13.csv,12,6,6,1218.75,60687.75
BANKNIFTY15NOV1825500PE_2018-11-13.csv,11,3,8,-399.0,46482.0
BANKNIFTY15NOV1825600CE_2018-11-13.csv,9,5,4,999.75,35499.75
BANKNIFTY15NOV1825600PE_2018-11-13.csv,8,2,6,-587.25,44330.25
BANKNIFTY15NOV1825700CE_2018-11-13.csv,11,6,5,1101.0,32653.5
BANKNIFTY15NOV1825700PE_2018-11-13.csv,9,2,7,-1092.0,72201.0
BANKNIFTY15NOV1825800CE_2018-11-13.csv,10,5,5,474.75,20405.25
BANKNIFTY15NOV1825800PE_2018-11-13.csv,13,3,10,-1706.25,118752.75
BANKNIFTY15NOV1825900CE_2018-11-13.csv,8,4,4,250.5,11944.5
BANKNIFTY15NOV1826000CE_2018-11-13.csv,11,6,5,267.0,10492.5
BANKNIFTY15NOV1825400PE_2018-11-14.csv,15,5,10,-100.5,6862.5
BANKNIFTY15NOV1825500PE_2018-11-14.csv,8,3,5,-15.75,5088.75
BANKNIFTY15NOV1825600CE_2018-11-14.csv,16,5,11,-1236.75,173772.0
BANKNIFTY15NOV1825600PE_2018-11-14.csv,14,4,10,-132.75,14073.75
BANKNIFTY15NOV1825700CE_2018-11-14.csv,13,5,8,309.75,107562.75
BANKNIFTY15NOV1825700PE_2018-11-14.csv,6,1,5,-234.0,7896.75
BANKNIFTY15NOV1825800CE_2018-11-14.csv,10,2,8,-1134.0,61048.5
BANKNIFTY15NOV1825800PE_2018-11-14.csv,10,2,8,-439.5,21355.5
BANKNIFTY15NOV1825900CE_2018-11-14.csv,11,3,8,-637.5,44193.0
BANKNIFTY15NOV1825900PE_2018-11-14.csv,12,4,8,-225.75,35855.25
BANKNIFTY15NOV1826000CE_2018-11-14.csv,9,1,8,-744.75,23778.75
BANKNIFTY15NOV1826000PE_2018-11-14.csv,10,4,6,174.0,43858.5
BANKNIFTY15NOV1826100CE_2018-11-14.csv,14,3,11,-513.75,22077.75
BANKNIFTY15NOV1826100PE_2018-11-14.csv,18,4,14,-1618.5,118956.0
BANKNIFTY15NOV1826200CE_2018-11-14.csv,13,5,8,-93.75,12077.25
BANKNIFTY15NOV1826200PE_2018-11-14.csv,22,10,12,2076.75,196190.25
BANKNIFTY15NOV1826300CE_2018-11-14.csv,15,6,9,-54.0,8127.0
BANKNIFTY15NOV1826300PE_2018-11-14.csv,23,10,13,1485.0,261013.5
BANKNIFTY15NOV1825600CE_2018-11-15.csv,6,5,1,3043.5,81963.75
BANKNIFTY15NOV1825700CE_2018-11-15.csv,9,5,4,1788.0,90887.25
BANKNIFTY15NOV1825800CE_2018-11-15.csv,12,5,7,345.0,83409.0
BANKNIFTY15NOV1825800PE_2018-11-15.csv,27,11,16,-108.0,6753.75
BANKNIFTY15NOV1825900CE_2018-11-15.csv,10,5,5,254.25,44716.5
BANKNIFTY15NOV1825900PE_2018-11-15.csv,23,9,14,-325.5,12959.25
BANKNIFTY15NOV1826000CE_2018-11-15.csv,14,6,8,-123.0,38921.25
BANKNIFTY15NOV1826000PE_2018-11-15.csv,14,7,7,-711.75,16566.0
BANKNIFTY15NOV1826100CE_2018-11-15.csv,19,9,10,94.5,18796.5
BANKNIFTY15NOV1826100PE_2018-11-15.csv,13,3,10,-792.75,40228.5
BANKNIFTY15NOV1826200PE_2018-11-15.csv,16,6,10,-1146.0,72115.5
BANKNIFTY15NOV1826300PE_2018-11-15.csv,13,3,10,-1745.25,102919.5
BANKNIFTY22NOV1825300PE_2018-11-16.csv,13,4,9,-116.25,8909.25
BANKNIFTY22NOV1825400PE_2018-11-16.csv,14,3,11,-204.75,12533.25
BANKNIFTY22NOV1825500PE_2018-11-16.csv,10,3,7,-130.5,11007.0
BANKNIFTY22NOV1825600PE_2018-11-16.csv,11,5,6,104.25,17097.75
BANKNIFTY22NOV1825700PE_2018-11-16.csv,10,2,8,-342.0,19312.5
BANKNIFTY22NOV1825800PE_2018-11-16.csv,8,3,5,-126.0,19702.5
BANKNIFTY22NOV1825900PE_2018-11-16.csv,10,4,6,48.0,31530.0
BANKNIFTY22NOV1826000CE_2018-11-16.csv,8,3,5,-368.25,88447.5
BANKNIFTY22NOV1826000PE_2018-11-16.csv,8,2,6,-378.0,31770.0
BANKNIFTY22NOV1826100CE_2018-11-16.csv,10,4,6,173.25,85697.25
BANKNIFTY22NOV1826100PE_2018-11-16.csv,8,4,4,391.5,41820.0
BANKNIFTY22NOV1826200CE_2018-11-16.csv,9,1,8,-1308.0,65416.5
BANKNIFTY22NOV1826200PE_2018-11-16.csv,8,3,5,-169.5,54106.5
BANKNIFTY22NOV1826300CE_2018-11-16.csv,9,2,7,-862.5,51046.5
BANKNIFTY22NOV1826300PE_2018-11-16.csv,10,5,5,897.75,79344.75
BANKNIFTY22NOV1826400CE_2018-11-16.csv,7,1,6,-858.0,28441.5
BANKNIFTY22NOV1826400PE_2018-11-16.csv,11,5,6,705.75,110151.0
BANKNIFTY22NOV1826500CE_2018-11-16.csv,10,3,7,-342.0,30778.5
BANKNIFTY22NOV1826600CE_2018-11-16.csv,2,0,2,-214.5,4432.5
BANKNIFTY22NOV1826700CE_2018-11-16.csv,7,2,5,-109.5,11465.25
BANKNIFTY22NOV1826800CE_2018-11-16.csv,7,3,4,-9.75,8133.0
BANKNIFTY22NOV1826900CE_2018-11-16.csv,9,4,5,-15.0,6357.0
BANKNIFTY22NOV1825400PE_2018-11-19.csv,13,4,9,-34.5,9931.5
BANKNIFTY22NOV1825500PE_2018-11-19.csv,8,2,6,-24.75,8010.75
BANKNIFTY22NOV1825600PE_2018-11-19.csv,10,3,7,-93.75,13627.5
BANKNIFTY22NOV1825700PE_2018-11-19.csv,8,2,6,-148.5,13582.5
BANKNIFTY22NOV1825800PE_2018-11-19.csv,7,2,5,-60.0,15984.75
BANKNIFTY22NOV1825900PE_2018-11-19.csv,7,2,5,-122.25,19550.25
BANKNIFTY22NOV1826000PE_2018-11-19.csv,8,4,4,305.25,29733.75
BANKNIFTY22NOV1826100CE_2018-11-19.csv,5,2,3,-241.5,52301.25
BANKNIFTY22NOV1826100PE_2018-11-19.csv,9,3,6,-171.0,41467.5
BANKNIFTY22NOV1826200CE_2018-11-19.csv,5,2,3,-199.5,38910.0
BANKNIFTY22NOV1826200PE_2018-11-19.csv,7,2,5,-216.0,41581.5
BANKNIFTY22NOV1826300CE_2018-11-19.csv,6,4,2,621.0,36325.5
BANKNIFTY22NOV1826300PE_2018-11-19.csv,10,3,7,-9.75,71294.25
BANKNIFTY22NOV1826400CE_2018-11-19.csv,5,3,2,137.25,24195.75
BANKNIFTY22NOV1826400PE_2018-11-19.csv,8,3,5,240.75,66980.25
BANKNIFTY22NOV1826500CE_2018-11-19.csv,6,3,3,-28.5,21361.5
BANKNIFTY22NOV1826500PE_2018-11-19.csv,6,2,4,-140.25,59465.25
BANKNIFTY22NOV1826600CE_2018-11-19.csv,6,3,3,-44.25,16079.25
BANKNIFTY22NOV1826700CE_2018-11-19.csv,5,3,2,46.5,9046.5
BANKNIFTY22NOV1826800CE_2018-11-19.csv,7,4,3,34.5,8901.0
BANKNIFTY22NOV1826900CE_2018-11-19.csv,8,4,4,42.75,6809.25
BANKNIFTY22NOV1825500PE_2018-11-20.csv,16,6,10,-45.75,8663.25
BANKNIFTY22NOV1825600PE_2018-11-20.csv,14,4,10,-126.75,10151.25
BANKNIFTY22NOV1825700PE_2018-11-20.csv,12,3,9,-157.5,12921.0
BANKNIFTY22NOV1825800PE_2018-11-20.csv,11,4,7,-34.5,16836.0
BANKNIFTY22NOV1825900PE_2018-11-20.csv,10,3,7,-153.75,22115.25
BANKNIFTY22NOV1826000CE_2018-11-20.csv,11,3,8,-952.5,84757.5
BANKNIFTY22NOV1826000PE_2018-11-20.csv,8,3,5,59.25,24479.25
BANKNIFTY22NOV1826100CE_2018-11-20.csv,10,4,6,-123.75,60161.25
BANKNIFTY22NOV1826100PE_2018-11-20.csv,8,3,5,157.5,33013.5
BANKNIFTY22NOV1826200CE_2018-11-20.csv,12,4,8,-430.5,55107.75
BANKNIFTY22NOV1826200PE_2018-11-20.csv,6,3,3,567.75,34320.75
BANKNIFTY22NOV1826300CE_2018-11-20.csv,8,2,6,-336.75,23373.75
BANKNIFTY22NOV1826300PE_2018-11-20.csv,9,4,5,153.75,64230.75
BANKNIFTY22NOV1826400CE_2018-11-20.csv,5,2,3,-78.75,10859.25
BANKNIFTY22NOV1826400PE_2018-11-20.csv,12,5,7,568.5,110643.0
BANKNIFTY22NOV1826500CE_2018-11-20.csv,8,2,6,-99.0,9490.5
BANKNIFTY22NOV1826600CE_2018-11-20.csv,10,3,7,-101.25,8627.25
BANKNIFTY22NOV1826700CE_2018-11-20.csv,13,5,8,-20.25,7713.75
BANKNIFTY22NOV1825800PE_2018-11-21.csv,12,3,9,-195.0,6445.5
BANKNIFTY22NOV1825900CE_2018-11-21.csv,16,7,9,663.0,176300.25
BANKNIFTY22NOV1825900PE_2018-11-21.csv,8,3,5,-174.75,6153.75
BANKNIFTY22NOV1826000CE_2018-11-21.csv,12,6,6,1038.75,101613.0
BANKNIFTY22NOV1826000PE_2018-11-21.csv,5,2,3,-159.75,6353.25
BANKNIFTY22NOV1826100CE_2018-11-21.csv,11,6,5,547.5,64008.75
BANKNIFTY22NOV1826100PE_2018-11-21.csv,7,0,7,-612.75,13554.75
BANKNIFTY22NOV1826200CE_2018-11-21.csv,12,6,6,583.5,47373.0
BANKNIFTY22NOV1826200PE_2018-11-21.csv,8,4,4,-393.75,24293.25
BANKNIFTY22NOV1826300CE_2018-11-21.csv,11,8,3,890.25,28896.75
BANKNIFTY22NOV1826300PE_2018-11-21.csv,13,3,10,-1251.0,55852.5
BANKNIFTY22NOV1826400CE_2018-11-21.csv,10,4,6,-29.25,15596.25
BANKNIFTY22NOV1826400PE_2018-11-21.csv,12,3,9,-1532.25,79236.75
BANKNIFTY22NOV1826500CE_2018-11-21.csv,11,3,8,-123.75,9464.25
BANKNIFTY22NOV1826500PE_2018-11-21.csv,11,5,6,-245.25,89723.25
BANKNIFTY22NOV1826000CE_2018-11-22.csv,13,5,8,-819.0,79091.25
BANKNIFTY22NOV1826100CE_2018-11-22.csv,12,5,7,36.75,30988.5
BANKNIFTY22NOV1826100PE_2018-11-22.csv,17,7,10,-60.0,10942.5
BANKNIFTY22NOV1826200CE_2018-11-22.csv,15,6,9,171.75,16071.0
BANKNIFTY22NOV1826200PE_2018-11-22.csv,14,5,9,22.5,24251.25
BANKNIFTY22NOV1826300CE_2018-11-22.csv,23,10,13,-420.75,9841.5
BANKNIFTY22NOV1826300PE_2018-11-22.csv,13,7,6,1121.25,53196.75
BANKNIFTY22NOV1826400CE_2018-11-22.csv,31,12,19,-292.5,5435.25
BANKNIFTY22NOV1826400PE_2018-11-22.csv,12,5,7,1001.25,75687.75
BANKNIFTY22NOV1826500PE_2018-11-22.csv,10,6,4,2464.5,91945.5
BANKNIFTY22NOV1826600PE_2018-11-22.csv,14,7,7,2460.0,170623.5
BANKNIFTY29NOV1825400PE_2018-11-26.csv,13,5,8,13.5,7578.0
BANKNIFTY29NOV1825500PE_2018-11-26.csv,11,2,9,-66.0,8244.0
BANKNIFTY29NOV1825600PE_2018-11-26.csv,8,3,5,-47.25,8831.25
BANKNIFTY29NOV1825700PE_2018-11-26.csv,10,2,8,-295.5,14371.5
BANKNIFTY29NOV1825800PE_2018-11-26.csv,10,2,8,-325.5,19012.5
BANKNIFTY29NOV1825900CE_2018-11-26.csv,10,8,2,3815.25,109838.25
BANKNIFTY29NOV1825900PE_2018-11-26.csv,8,2,6,-9.75,21273.75
BANKNIFTY29NOV1826000CE_2018-11-26.csv,5,3,2,813.75,45441.0
BANKNIFTY29NOV1826000PE_2018-11-26.csv,8,2,6,-395.25,28956.75
BANKNIFTY29NOV1826100CE_2018-11-26.csv,7,5,2,1584.0,46329.0
BANKNIFTY29NOV1826100PE_2018-11-26.csv,11,3,8,-240.75,49946.25
BANKNIFTY29NOV1826200CE_2018-11-26.csv,5,4,1,735.75,26452.5
BANKNIFTY29NOV1826200PE_2018-11-26.csv,11,3,8,-505.5,65395.5
BANKNIFTY29NOV1826300CE_2018-11-26.csv,9,6,3,1081.5,33235.5
BANKNIFTY29NOV1826300PE_2018-11-26.csv,11,3,8,-150.0,82146.75
BANKNIFTY29NOV1826400CE_2018-11-26.csv,8,4,4,167.25,19697.25
BANKNIFTY29NOV1826400PE_2018-11-26.csv,11,1,10,-2658.0,102295.5
BANKNIFTY29NOV1826500CE_2018-11-26.csv,7,4,3,267.75,11714.25
BANKNIFTY29NOV1826600CE_2018-11-26.csv,11,5,6,101.25,11460.75
BANKNIFTY29NOV1825900PE_2018-11-27.csv,17,8,9,228.75,13694.25
BANKNIFTY29NOV1826000PE_2018-11-27.csv,13,3,10,-264.75,14744.25
BANKNIFTY29NOV1826100CE_2018-11-27.csv,11,6,5,1469.25,106182.75
BANKNIFTY29NOV1826100PE_2018-11-27.csv,11,4,7,44.25,18855.75
BANKNIFTY29NOV1826200CE_2018-11-27.csv,13,5,8,265.5,94143.0
BANKNIFTY29NOV1826200PE_2018-11-27.csv,9,3,6,-128.25,20250.75
BANKNIFTY29NOV1826300CE_2018-11-27.csv,10,4,6,264.0,51781.5
BANKNIFTY29NOV1826300PE_2018-11-27.csv,10,2,8,-731.25,31497.75
BANKNIFTY29NOV1826400CE_2018-11-27.csv,8,3,5,56.25,30978.75
BANKNIFTY29NOV1826400PE_2018-11-27.csv,13,5,8,-263.25,57542.25
BANKNIFTY29NOV1826500CE_2018-11-27.csv,9,2,7,-327.75,22431.75
BANKNIFTY29NOV1826500PE_2018-11-27.csv,12,5,7,522.75,76205.25
BANKNIFTY29NOV1826600CE_2018-11-27.csv,10,1,9,-548.25,15198.75
BANKNIFTY29NOV1826600PE_2018-11-27.csv,14,4,10,-500.25,116654.25
BANKNIFTY29NOV1826700CE_2018-11-27.csv,11,4,7,-107.25,9626.25
BANKNIFTY29NOV1826200CE_2018-11-28.csv,9,1,8,-1892.25,77474.25
BANKNIFTY29NOV1826200PE_2018-11-28.csv,7,2,5,-23.25,5267.25
BANKNIFTY29NOV1826300CE_2018-11-28.csv,14,5,9,-479.25,88022.25
BANKNIFTY29NOV1826300PE_2018-11-28.csv,9,3,6,46.5,11310.0
BANKNIFTY29NOV1826400CE_2018-11-28.csv,8,4,4,3.0,34918.5
BANKNIFTY29NOV1826400PE_2018-11-28.csv,10,4,6,159.0,21336.0
BANKNIFTY29NOV1826500CE_2018-11-28.csv,11,2,9,-746.25,29072.25
BANKNIFTY29NOV1826500PE_2018-11-28.csv,9,4,5,192.75,30149.25
BANKNIFTY29NOV1826600CE_2018-11-28.csv,11,4,7,57.75,18515.25
BANKNIFTY29NOV1826600PE_2018-11-28.csv,12,6,6,821.25,59208.75
BANKNIFTY29NOV1826700CE_2018-11-28.csv,12,5,7,-73.5,9658.5
BANKNIFTY29NOV1826700PE_2018-11-28.csv,11,6,5,1343.25,76632.75
BANKNIFTY29NOV1826800CE_2018-11-28.csv,10,4,6,-36.75,4533.75
BANKNIFTY29NOV1826800PE_2018-11-28.csv,14,6,8,1215.75,141578.25
BANKNIFTY29NOV1826300CE_2018-11-29.csv,9,6,3,1879.5,116215.5
BANKNIFTY29NOV1826400CE_2018-11-29.csv,13,7,6,2304.75,134214.75
BANKNIFTY29NOV1826500CE_2018-11-29.csv,7,2,5,-1305.75,55685.25
BANKNIFTY29NOV1826500PE_2018-11-29.csv,16,3,13,-138.0,2973.75
BANKNIFTY29NOV1826600CE_2018-11-29.csv,10,3,7,56.25,44232.75
BANKNIFTY29NOV1826600PE_2018-11-29.csv,18,9,9,-246.75,5460.0
BANKNIFTY29NOV1826700CE_2018-11-29.csv,10,4,6,-1106.25,20486.25
BANKNIFTY29NOV1826700PE_2018-11-29.csv,17,8,9,-125.25,12849.0
BANKNIFTY29NOV1826800PE_2018-11-29.csv,9,0,9,-836.25,21447.0
BANKNIFTY29NOV1826900PE_2018-11-29.csv,16,4,12,-2106.0,62085.75
BANKNIFTY29NOV1827000PE_2018-11-29.csv,13,4,9,-1259.25,88505.25
BANKNIFTY06DEC1826200PE_2018-11-30.csv,11,4,7,-29.25,10902.75
BANKNIFTY06DEC1826300PE_2018-11-30.csv,10,4,6,17.25,13845.75
BANKNIFTY06DEC1826400PE_2018-11-30.csv,9,4,5,138.0,15951.0
BANKNIFTY06DEC1826500PE_2018-11-30.csv,4,2,2,63.75,10157.25
BANKNIFTY06DEC1826600PE_2018-11-30.csv,6,3,3,118.5,20583.0
BANKNIFTY06DEC1826700CE_2018-11-30.csv,10,1,9,-1780.5,94071.0
BANKNIFTY06DEC1826700PE_2018-11-30.csv,8,4,4,198.0,36372.0
BANKNIFTY06DEC1826800CE_2018-11-30.csv,7,1,6,-1119.0,52782.0
BANKNIFTY06DEC1826800PE_2018-11-30.csv,5,1,4,-708.0,30577.5
BANKNIFTY06DEC1826900CE_2018-11-30.csv,8,1,7,-1031.25,49110.75
BANKNIFTY06DEC1826900PE_2018-11-30.csv,7,4,3,619.5,49677.0
BANKNIFTY06DEC1827000CE_2018-11-30.csv,9,2,7,-749.25,43628.25
BANKNIFTY06DEC1827000PE_2018-11-30.csv,6,3,3,431.25,56193.75
BANKNIFTY06DEC1827100CE_2018-11-30.csv,8,1,7,-775.5,30435.0
BANKNIFTY06DEC1827100PE_2018-11-30.csv,7,3,4,229.5,79125.75
BANKNIFTY06DEC1827200CE_2018-11-30.csv,7,1,6,-561.0,18627.0
BANKNIFTY06DEC1827300CE_2018-11-30.csv,8,2,6,-221.25,16771.5
BANKNIFTY06DEC1827400CE_2018-11-30.csv,6,2,4,-101.25,9387.75
BANKNIFTY06DEC1827500CE_2018-11-30.csv,12,4,8,-96.75,13356.75
BANKNIFTY06DEC1827600CE_2018-11-30.csv,16,4,12,-164.25,11409.75
BANKNIFTY06DEC1826200PE_2018-12-03.csv,13,6,7,116.25,8994.75
BANKNIFTY06DEC1826300PE_2018-12-03.csv,12,5,7,60.0,11793.0
BANKNIFTY06DEC1826400PE_2018-12-03.csv,8,4,4,125.25,11406.75
BANKNIFTY06DEC1826500PE_2018-12-03.csv,6,3,3,110.25,12546.0
BANKNIFTY06DEC1826600PE_2018-12-03.csv,10,5,5,366.0,27171.75
BANKNIFTY06DEC1826700CE_2018-12-03.csv,5,2,3,138.0,51102.0
BANKNIFTY06DEC1826700PE_2018-12-03.csv,7,4,3,397.5,26515.5
BANKNIFTY06DEC1826800CE_2018-12-03.csv,5,1,4,-540.75,40956.75
BANKNIFTY06DEC1826800PE_2018-12-03.csv,5,3,2,363.0,26580.75
BANKNIFTY06DEC1826900CE_2018-12-03.csv,6,2,4,-227.25,37973.25
BANKNIFTY06DEC1826900PE_2018-12-03.csv,3,2,1,396.0,21436.5
BANKNIFTY06DEC1827000CE_2018-12-03.csv,7,2,5,-348.0,34656.0
BANKNIFTY06DEC1827000PE_2018-12-03.csv,7,2,5,-291.75,57754.5
BANKNIFTY06DEC1827100CE_2018-12-03.csv,5,3,2,360.0,18839.25
BANKNIFTY06DEC1827100PE_2018-12-03.csv,8,2,6,-622.5,80658.75
BANKNIFTY06DEC1827200CE_2018-12-03.csv,4,0,4,-393.0,11418.75
BANKNIFTY06DEC1827300CE_2018-12-03.csv,6,2,4,-31.5,12004.5
BANKNIFTY06DEC1827400CE_2018-12-03.csv,6,1,5,-135.75,8474.25
BANKNIFTY06DEC1827500CE_2018-12-03.csv,7,3,4,0.0,6531.0
BANKNIFTY06DEC1827600CE_2018-12-03.csv,7,3,4,1.5,3991.5
BANKNIFTY06DEC1827700CE_2018-12-03.csv,14,4,10,-24.0,4743.0
BANKNIFTY06DEC1826300PE_2018-12-04.csv,10,4,6,82.5,9909.75
BANKNIFTY06DEC1826400PE_2018-12-04.csv,11,4,7,39.75,16574.25
BANKNIFTY06DEC1826500CE_2018-12-04.csv,6,0,6,-1896.75,61784.25
BANKNIFTY06DEC1826500PE_2018-12-04.csv,9,3,6,-114.75,19632.75
BANKNIFTY06DEC1826600CE_2018-12-04.csv,5,1,4,-976.5,38790.0
BANKNIFTY06DEC1826600PE_2018-12-04.csv,8,4,4,214.5,24814.5
BANKNIFTY06DEC1826700CE_2018-12-04.csv,8,3,5,-404.25,46866.75
BANKNIFTY06DEC1826700PE_2018-12-04.csv,8,3,5,-13.5,35551.5
BANKNIFTY06DEC1826800CE_2018-12-04.csv,6,1,5,-691.5,27307.5
BANKNIFTY06DEC1826800PE_2018-12-04.csv,6,3,3,321.75,39697.5
BANKNIFTY06DEC1826900CE_2018-12-04.csv,9,4,5,-43.5,27357.0
BANKNIFTY06DEC1826900PE_2018-12-04.csv,6,3,3,279.75,51144.75
BANKNIFTY06DEC1827000CE_2018-12-04.csv,7,3,4,-60.75,16056.75
BANKNIFTY06DEC1827000PE_2018-12-04.csv,5,2,3,79.5,53551.5
BANKNIFTY06DEC1827100CE_2018-12-04.csv,10,3,7,-87.0,15895.5
BANKNIFTY06DEC1827200CE_2018-12-04.csv,10,3,7,-106.5,10339.5
BANKNIFTY06DEC1827300CE_2018-12-04.csv,13,3,10,-210.75,8559.75
BANKNIFTY06DEC1827400CE_2018-12-04.csv,14,4,10,-84.75,5630.25
BANKNIFTY06DEC1826200PE_2018-12-05.csv,10,4,6,-27.75,6456.75
BANKNIFTY06DEC1826300CE_2018-12-05.csv,8,5,3,1646.25,77139.0
BANKNIFTY06DEC1826300PE_2018-12-05.csv,12,5,7,36.75,13212.75
BANKNIFTY06DEC1826400CE_2018-12-05.csv,9,4,5,325.5,67037.25
BANKNIFTY06DEC1826400PE_2018-12-05.csv,8,2,6,-203.25,14156.25
BANKNIFTY06DEC1826500CE_2018-12-05.csv,5,3,2,538.5,28971.75
BANKNIFTY06DEC1826500PE_2018-12-05.csv,8,4,4,219.75,21075.75
BANKNIFTY06DEC1826600CE_2018-12-05.csv,5,1,4,-428.25,19623.75
BANKNIFTY06DEC1826600PE_2018-12-05.csv,9,3,6,-59.25,35378.25
BANKNIFTY06DEC1826700CE_2018-12-05.csv,7,4,3,205.5,16411.5
BANKNIFTY06DEC1826700PE_2018-12-05.csv,8,4,4,584.25,45029.25
BANKNIFTY06DEC1826800CE_2018-12-05.csv,9,3,6,-175.5,12588.0
BANKNIFTY06DEC1826800PE_2018-12-05.csv,7,1,6,-1455.75,57838.5
BANKNIFTY06DEC1826900CE_2018-12-05.csv,6,2,4,-135.0,5446.5
BANKNIFTY06DEC1826900PE_2018-12-05.csv,4,0,4,-1983.0,44089.5
BANKNIFTY06DEC1827000CE_2018-12-05.csv,12,6,6,22.5,6468.75
BANKNIFTY06DEC1825900CE_2018-12-06.csv,16,3,13,-3156.0,153333.0
BANKNIFTY06DEC1826000CE_2018-12-06.csv,7,1,6,-1051.5,45901.5
BANKNIFTY06DEC1826100CE_2018-12-06.csv,5,0,5,-801.75,17465.25
BANKNIFTY06DEC1826100PE_2018-12-06.csv,18,5,13,-300.75,10123.5
BANKNIFTY06DEC1826200CE_2018-12-06.csv,6,1,5,-384.0,7969.5
BANKNIFTY06DEC1826200PE_2018-12-06.csv,16,7,9,-346.5,21325.5
BANKNIFTY06DEC1826300CE_2018-12-06.csv,13,5,8,-101.25,5886.0
BANKNIFTY06DEC1826300PE_2018-12-06.csv,12,4,8,-636.0,40086.75
BANKNIFTY06DEC1826400CE_2018-12-06.csv,17,10,7,-21.75,2133.0
BANKNIFTY06DEC1826400PE_2018-12-06.csv,12,4,8,-285.75,63185.25
BANKNIFTY06DEC1826500CE_2018-12-06.csv,33,16,17,15.75,1947.0
BANKNIFTY06DEC1826500PE_2018-12-06.csv,11,6,5,792.75,89561.25
BANKNIFTY06DEC1826600CE_2018-12-06.csv,36,21,15,-2.25,835.5
BANKNIFTY06DEC1826600PE_2018-12-06.csv,8,3,5,-545.25,94974.0
BANKNIFTY06DEC1826700PE_2018-12-06.csv,12,6,6,1626.0,162229.5
BANKNIFTY13DEC1824900PE_2018-12-07.csv,10,3,7,-45.0,6764.25
BANKNIFTY13DEC1825000PE_2018-12-07.csv,11,4,7,18.0,9588.0
BANKNIFTY13DEC1825100PE_2018-12-07.csv,10,3,7,-40.5,10325.25
BANKNIFTY13DEC1825200PE_2018-12-07.csv,10,3,7,-104.25,12185.25
BANKNIFTY13DEC1825300PE_2018-12-07.csv,9,3,6,6.75,14265.0
BANKNIFTY13DEC1825400PE_2018-12-07.csv,10,2,8,-249.75,18321.75
BANKNIFTY13DEC1825500PE_2018-12-07.csv,7,0,7,-505.5,13777.5
BANKNIFTY13DEC1825600PE_2018-12-07.csv,6,0,6,-534.0,15878.25
BANKNIFTY13DEC1825700PE_2018-12-07.csv,6,0,6,-558.75,18696.75
BANKNIFTY13DEC1825800PE_2018-12-07.csv,3,0,3,-419.25,10571.25
BANKNIFTY13DEC1825900PE_2018-12-07.csv,6,0,6,-867.0,24930.75
BANKNIFTY13DEC1826000PE_2018-12-07.csv,5,1,4,-267.75,24383.25
BANKNIFTY13DEC1826100PE_2018-12-07.csv,9,1,8,-1258.5,51546.0
BANKNIFTY13DEC1826200PE_2018-12-07.csv,7,1,6,-978.75,47861.25
BANKNIFTY13DEC1826300PE_2018-12-07.csv,8,1,7,-1142.25,64095.75
BANKNIFTY13DEC1826400CE_2018-12-07.csv,6,4,2,1273.5,55093.5
BANKNIFTY13DEC1826400PE_2018-12-07.csv,9,1,8,-1861.5,80664.0
BANKNIFTY13DEC1826500CE_2018-12-07.csv,6,4,2,1221.0,46308.0
BANKNIFTY13DEC1826600CE_2018-12-07.csv,6,4,2,942.75,37290.75
BANKNIFTY13DEC1826700CE_2018-12-07.csv,7,4,3,616.5,34870.5
BANKNIFTY13DEC1826800CE_2018-12-07.csv,8,4,4,350.25,31215.75
BANKNIFTY13DEC1826900CE_2018-12-07.csv,10,5,5,251.25,30710.25
BANKNIFTY13DEC1827000CE_2018-12-07.csv,8,4,4,163.5,18532.5
BANKNIFTY13DEC1827100CE_2018-12-07.csv,9,4,5,133.5,15517.5
BANKNIFTY13DEC1827200CE_2018-12-07.csv,12,6,6,126.0,14973.0
BANKNIFTY13DEC1827300CE_2018-12-07.csv,11,5,6,6.75,9603.75
BANKNIFTY13DEC1824800PE_2018-12-10.csv,10,2,8,-106.5,7746.0
BANKNIFTY13DEC1824900PE_2018-12-10.csv,12,4,8,-9.0,10762.5
BANKNIFTY13DEC1825000PE_2018-12-10.csv,7,1,6,-144.75,7733.25
BANKNIFTY13DEC1825100PE_2018-12-10.csv,10,4,6,30.75,12626.25
BANKNIFTY13DEC1825200PE_2018-12-10.csv,8,1,7,-257.25,11597.25
BANKNIFTY13DEC1825300PE_2018-12-10.csv,7,2,5,-88.5,13159.5
BANKNIFTY13DEC1825400PE_2018-12-10.csv,4,1,3,-45.75,8631.75
BANKNIFTY13DEC1825500PE_2018-12-10.csv,5,2,3,-24.0,13842.0
BANKNIFTY13DEC1825600PE_2018-12-10.csv,7,3,4,143.25,23906.25
BANKNIFTY13DEC1825700PE_2018-12-10.csv,3,1,2,72.0,11572.5
BANKNIFTY13DEC1825800PE_2018-12-10.csv,3,1,2,18.0,16715.25
BANKNIFTY13DEC1825900PE_2018-12-10.csv,3,1,2,-59.25,19460.25
BANKNIFTY13DEC1826000CE_2018-12-10.csv,3,1,2,-269.25,46805.25
BANKNIFTY13DEC1826000PE_2018-12-10.csv,3,1,2,-90.75,18929.25
BANKNIFTY13DEC1826100CE_2018-12-10.csv,5,2,3,-180.75,62872.5
BANKNIFTY13DEC1826100PE_2018-12-10.csv,3,2,1,774.75,23255.25
BANKNIFTY13DEC1826200CE_2018-12-10.csv,5,1,4,-893.25,47964.75
BANKNIFTY13DEC1826200PE_2018-12-10.csv,5,2,3,157.5,47510.25
BANKNIFTY13DEC1826300CE_2018-12-10.csv,4,1,3,-528.0,36486.0
BANKNIFTY13DEC1826300PE_2018-12-10.csv,3,2,1,862.5,36731.25
BANKNIFTY13DEC1826400CE_2018-12-10.csv,5,1,4,-561.0,33133.5
BANKNIFTY13DEC1826500CE_2018-12-10.csv,6,3,3,194.25,32178.75
BANKNIFTY13DEC1826600CE_2018-12-10.csv,5,3,2,436.5,24802.5
BANKNIFTY13DEC1826700CE_2018-12-10.csv,5,4,1,638.25,18837.75
BANKNIFTY13DEC1826800CE_2018-12-10.csv,3,3,0,475.5,9312.75
BANKNIFTY13DEC1826900CE_2018-12-10.csv,7,5,2,399.0,13719.0
BANKNIFTY13DEC1827000CE_2018-12-10.csv,7,5,2,273.0,10135.5
BANKNIFTY13DEC1827100CE_2018-12-10.csv,8,5,3,159.75,8834.25
BANKNIFTY13DEC1827200CE_2018-12-10.csv,7,5,2,128.25,5713.5
BANKNIFTY13DEC1824100PE_2018-12-11.csv,23,9,14,-72.0,5743.5
BANKNIFTY13DEC1824200PE_2018-12-11.csv,24,6,18,-192.75,5687.25
BANKNIFTY13DEC1824300PE_2018-12-11.csv,28,9,19,-62.25,7563.75
BANKNIFTY13DEC1824400PE_2018-12-11.csv,21,8,13,-4.5,5943.0
BANKNIFTY13DEC1824500PE_2018-12-11.csv,19,4,15,-163.5,5605.5
BANKNIFTY13DEC1824600PE_2018-12-11.csv,19,6,13,-281.25,8147.25
BANKNIFTY13DEC1824700PE_2018-12-11.csv,15,5,10,-383.25,7640.25
BANKNIFTY13DEC1824800PE_2018-12-11.csv,16,4,12,-251.25,9951.75
BANKNIFTY13DEC1824900PE_2018-12-11.csv,13,2,11,-363.0,8203.5
BANKNIFTY13DEC1825000PE_2018-12-11.csv,8,1,7,-333.0,7816.5
BANKNIFTY13DEC1825100PE_2018-12-11.csv,10,3,7,-309.75,10884.75
BANKNIFTY13DEC1825200PE_2018-12-11.csv,10,3,7,-344.25,14222.25
BANKNIFTY13DEC1825300PE_2018-12-11.csv,6,1,5,-270.75,9129.75
BANKNIFTY13DEC1825400PE_2018-12-11.csv,8,1,7,-789.75,20165.25
BANKNIFTY13DEC1825500PE_2018-12-11.csv,10,0,10,-1245.75,28232.25
BANKNIFTY13DEC1825600CE_2018-12-11.csv,21,10,11,2511.75,294664.5
BANKNIFTY13DEC1825600PE_2018-12-11.csv,6,1,5,-674.25,19257.75
BANKNIFTY13DEC1825700CE_2018-12-11.csv,12,6,6,1555.5,142965.0
BANKNIFTY13DEC1825700PE_2018-12-11.csv,7,1,6,-797.25,26999.25
BANKNIFTY13DEC1825800CE_2018-12-11.csv,12,5,7,229.5,117151.5
BANKNIFTY13DEC1825800PE_2018-12-11.csv,9,1,8,-1191.0,39106.5
BANKNIFTY13DEC1825900CE_2018-12-11.csv,12,7,5,1506.0,99405.0
BANKNIFTY13DEC1825900PE_2018-12-11.csv,11,4,7,-593.25,58943.25
BANKNIFTY13DEC1826000CE_2018-12-11.csv,10,5,5,801.0,57621.0
BANKNIFTY13DEC1826000PE_2018-12-11.csv,8,1,7,-1214.25,47313.75
BANKNIFTY13DEC1826100CE_2018-12-11.csv,11,4,7,-351.75,52893.75
BANKNIFTY13DEC1826100PE_2018-12-11.csv,10,0,10,-3251.25,90072.75
BANKNIFTY13DEC1826200CE_2018-12-11.csv,10,5,5,10.5,40050.0
BANKNIFTY13DEC1826200PE_2018-12-11.csv,15,5,10,-1838.25,154100.25
BANKNIFTY13DEC1826300CE_2018-12-11.csv,10,4,6,-283.5,26952.0
BANKNIFTY13DEC1826300PE_2018-12-11.csv,16,5,11,-1709.25,205410.75
BANKNIFTY13DEC1826400CE_2018-12-11.csv,12,5,7,-15.75,21716.25
BANKNIFTY13DEC1826500CE_2018-12-11.csv,16,6,10,-96.75,19689.75
BANKNIFTY13DEC1826600CE_2018-12-11.csv,14,6,8,65.25,12246.75
BANKNIFTY13DEC1826700CE_2018-12-11.csv,12,4,8,-102.0,8140.5
BANKNIFTY13DEC1826800CE_2018-12-11.csv,17,10,7,177.0,8230.5
BANKNIFTY13DEC1825700PE_2018-12-12.csv,11,3,8,-23.25,1827.75
BANKNIFTY13DEC1825800PE_2018-12-12.csv,11,1,10,-54.75,2151.75
BANKNIFTY13DEC1825900PE_2018-12-12.csv,14,4,10,-48.0,3340.5
BANKNIFTY13DEC1826000CE_2018-12-12.csv,5,3,2,1494.75,83888.25
BANKNIFTY13DEC1826000PE_2018-12-12.csv,14,3,11,-51.0,4495.5
BANKNIFTY13DEC1826100CE_2018-12-12.csv,4,2,2,796.5,54281.25
BANKNIFTY13DEC1826100PE_2018-12-12.csv,11,3,8,-74.25,5327.25
BANKNIFTY13DEC1826200CE_2018-12-12.csv,6,3,3,455.25,60947.25
BANKNIFTY13DEC1826200PE_2018-12-12.csv,9,1,8,-342.0,7554.0
BANKNIFTY13DEC1826300CE_2018-12-12.csv,6,3,3,466.5,44207.25
BANKNIFTY13DEC1826300PE_2018-12-12.csv,6,0,6,-314.25,6815.25
BANKNIFTY13DEC1826400CE_2018-12-12.csv,6,3,3,323.25,32761.5
BANKNIFTY13DEC1826400PE_2018-12-12.csv,8,0,8,-698.25,16590.75
BANKNIFTY13DEC1826500CE_2018-12-12.csv,6,4,2,266.25,21326.25
BANKNIFTY13DEC1826500PE_2018-12-12.csv,6,0,6,-970.5,23541.0
BANKNIFTY13DEC1826600CE_2018-12-12.csv,7,4,3,198.0,18343.5
BANKNIFTY13DEC1826600PE_2018-12-12.csv,11,1,10,-1731.0,62505.0
BANKNIFTY13DEC1826700CE_2018-12-12.csv,6,5,1,294.0,8532.0
BANKNIFTY13DEC1826700PE_2018-12-12.csv,11,1,10,-2316.0,89356.5
BANKNIFTY13DEC1826500CE_2018-12-13.csv,4,2,2,225.0,38818.5
BANKNIFTY13DEC1826600CE_2018-12-13.csv,8,3,5,-333.0,65467.5
BANKNIFTY13DEC1826700CE_2018-12-13.csv,8,4,4,312.0,41202.0
BANKNIFTY13DEC1826700PE_2018-12-13.csv,19,11,8,76.5,3255.0
BANKNIFTY13DEC1826800CE_2018-12-13.csv,6,3,3,108.0,16993.5
BANKNIFTY13DEC1826800PE_2018-12-13.csv,11,5,6,171.75,7066.5
BANKNIFTY13DEC1826900CE_2018-12-13.csv,18,6,12,-41.25,15028.5
BANKNIFTY13DEC1826900PE_2018-12-13.csv,8,4,4,204.75,14079.75
BANKNIFTY13DEC1827000CE_2018-12-13.csv,16,9,7,54.75,3457.5
BANKNIFTY13DEC1827000PE_2018-12-13.csv,8,4,4,767.25,29781.75
BANKNIFTY13DEC1827100PE_2018-12-13.csv,9,4,5,690.0,60056.25
BANKNIFTY13DEC1827200PE_2018-12-13.csv,13,4,9,-351.0,125463.0
BANKNIFTY20DEC1826000PE_2018-12-14.csv,12,2,10,-144.75,8547.75
BANKNIFTY20DEC1826100PE_2018-12-14.csv,11,1,10,-259.5,10443.0
BANKNIFTY20DEC1826200PE_2018-12-14.csv,12,3,9,-210.75,14427.75
BANKNIFTY20DEC1826300PE_2018-12-14.csv,7,1,6,-291.75,11475.75
BANKNIFTY20DEC1826400PE_2018-12-14.csv,9,2,7,-290.25,20061.75
BANKNIFTY20DEC1826500PE_2018-12-14.csv,5,1,4,-311.25,14837.25
BANKNIFTY20DEC1826600CE_2018-12-14.csv,13,4,9,-900.0,123532.5
BANKNIFTY20DEC1826600PE_2018-12-14.csv,9,1,8,-811.5,33427.5
BANKNIFTY20DEC1826700CE_2018-12-14.csv,12,3,9,-1093.5,96118.5
BANKNIFTY20DEC1826700PE_2018-12-14.csv,5,0,5,-906.75,24134.25
BANKNIFTY20DEC1826800CE_2018-12-14.csv,7,2,5,-259.5,47604.0
BANKNIFTY20DEC1826800PE_2018-12-14.csv,7,1,6,-991.5,43114.5
BANKNIFTY20DEC1826900CE_2018-12-14.csv,11,4,7,-51.0,55179.0
BANKNIFTY20DEC1826900PE_2018-12-14.csv,6,1,5,-1010.25,50539.5
BANKNIFTY20DEC1827000CE_2018-12-14.csv,6,2,4,-42.75,23325.75
BANKNIFTY20DEC1827000PE_2018-12-14.csv,6,1,5,-951.75,62104.5
BANKNIFTY20DEC1827100CE_2018-12-14.csv,11,2,9,-606.0,34665.0
BANKNIFTY20DEC1827200CE_2018-12-14.csv,6,2,4,-30.0,15195.0
BANKNIFTY20DEC1827300CE_2018-12-14.csv,12,4,8,-114.75,19599.75
BANKNIFTY20DEC1827400CE_2018-12-14.csv,15,3,12,-378.75,17171.25
BANKNIFTY20DEC1827500CE_2018-12-14.csv,12,2,10,-216.0,9874.5
BANKNIFTY20DEC1826200PE_2018-12-17.csv,13,4,9,-27.75,4619.25
BANKNIFTY20DEC1826300PE_2018-12-17.csv,7,2,5,-32.25,3272.25
BANKNIFTY20DEC1826400PE_2018-12-17.csv,10,5,5,89.25,6576.75
BANKNIFTY20DEC1826500PE_2018-12-17.csv,9,5,4,162.75,8130.75
BANKNIFTY20DEC1826600PE_2018-12-17.csv,8,3,5,29.25,10344.0
BANKNIFTY20DEC1826700CE_2018-12-17.csv,6,2,4,-108.0,68418.0
BANKNIFTY20DEC1826700PE_2018-12-17.csv,5,2,3,8.25,10104.75
BANKNIFTY20DEC1826800CE_2018-12-17.csv,5,2,3,-8.25,47099.25
BANKNIFTY20DEC1826800PE_2018-12-17.csv,6,2,4,-116.25,16526.25
BANKNIFTY20DEC1826900CE_2018-12-17.csv,6,3,3,516.0,43302.75
BANKNIFTY20DEC1826900PE_2018-12-17.csv,4,2,2,148.5,16327.5
BANKNIFTY20DEC1827000CE_2018-12-17.csv,6,2,4,61.5,32476.5
BANKNIFTY20DEC1827000PE_2018-12-17.csv,5,2,3,-73.5,26260.5
BANKNIFTY20DEC1827100CE_2018-12-17.csv,6,2,4,-159.75,23830.5
BANKNIFTY20DEC1827100PE_2018-12-17.csv,4,2,2,218.25,28638.75
BANKNIFTY20DEC1827200CE_2018-12-17.csv,7,2,5,-159.0,20364.0
BANKNIFTY20DEC1827200PE_2018-12-17.csv,7,2,5,-594.75,63297.75
BANKNIFTY20DEC1827300CE_2018-12-17.csv,8,3,5,13.5,16015.5
BANKNIFTY20DEC1827400CE_2018-12-17.csv,9,3,6,-108.0,11436.0
BANKNIFTY20DEC1827500CE_2018-12-17.csv,9,3,6,-30.0,7204.5
BANKNIFTY20DEC1826500PE_2018-12-18.csv,11,3,8,-92.25,8070.75
BANKNIFTY20DEC1826600PE_2018-12-18.csv,6,1,5,-131.25,6388.5
BANKNIFTY20DEC1826700CE_2018-12-18.csv,6,4,2,1753.5,66502.5
BANKNIFTY20DEC1826700PE_2018-12-18.csv,7,1,6,-245.25,10194.75
BANKNIFTY20DEC1826800CE_2018-12-18.csv,5,3,2,800.25,43686.0
BANKNIFTY20DEC1826800PE_2018-12-18.csv,8,2,6,-199.5,20617.5
BANKNIFTY20DEC1826900CE_2018-12-18.csv,5,4,1,883.5,25018.5
BANKNIFTY20DEC1826900PE_2018-12-18.csv,7,2,5,-133.5,24963.0
BANKNIFTY20DEC1827000CE_2018-12-18.csv,7,5,2,944.25,28440.75
BANKNIFTY20DEC1827000PE_2018-12-18.csv,7,2,5,-191.25,33859.5
BANKNIFTY20DEC1827100CE_2018-12-18.csv,6,4,2,326.25,13967.25
BANKNIFTY20DEC1827100PE_2018-12-18.csv,5,1,4,-440.25,30320.25
BANKNIFTY20DEC1827200CE_2018-12-18.csv,7,4,3,318.0,14875.5
BANKNIFTY20DEC1827200PE_2018-12-18.csv,5,0,5,-1020.75,34278.75
BANKNIFTY20DEC1827300CE_2018-12-18.csv,6,5,1,438.0,9733.5
BANKNIFTY20DEC1827400CE_2018-12-18.csv,8,5,3,183.75,4979.25
BANKNIFTY20DEC1826900PE_2018-12-19.csv,14,4,10,-62.25,7761.75
BANKNIFTY20DEC1827000CE_2018-12-19.csv,7,3,4,300.0,72888.0
BANKNIFTY20DEC1827000PE_2018-12-19.csv,10,4,6,-98.25,9039.0
BANKNIFTY20DEC1827100CE_2018-12-19.csv,7,4,3,568.5,52873.5
BANKNIFTY20DEC1827100PE_2018-12-19.csv,11,5,6,25.5,14398.5
BANKNIFTY20DEC1827200CE_2018-12-19.csv,9,4,5,61.5,51301.5
BANKNIFTY20DEC1827200PE_2018-12-19.csv,6,3,3,-10.5,13087.5
BANKNIFTY20DEC1827300CE_2018-12-19.csv,8,5,3,421.5,29284.5
BANKNIFTY20DEC1827300PE_2018-12-19.csv,8,3,5,95.25,26046.75
BANKNIFTY20DEC1827400CE_2018-12-19.csv,5,2,3,-143.25,12131.25
BANKNIFTY20DEC1827400PE_2018-12-19.csv,9,2,7,-387.75,44138.25
BANKNIFTY20DEC1827500CE_2018-12-19.csv,8,4,4,186.0,13094.25
BANKNIFTY20DEC1827500PE_2018-12-19.csv,9,3,6,39.75,59868.75
BANKNIFTY20DEC1827600CE_2018-12-19.csv,12,6,6,161.25,10969.5
BANKNIFTY20DEC1827600PE_2018-12-19.csv,15,5,10,-129.75,138882.75
BANKNIFTY20DEC1826800CE_2018-12-20.csv,12,5,7,458.25,142354.5
BANKNIFTY20DEC1826900CE_2018-12-20.csv,16,7,9,740.25,136292.25
BANKNIFTY20DEC1826900PE_2018-12-20.csv,33,18,15,-23.25,2190.0
BANKNIFTY20DEC1827000CE_2018-12-20.csv,11,7,4,1354.5,65553.0
BANKNIFTY20DEC1827000PE_2018-12-20.csv,27,13,14,-126.75,6290.25
BANKNIFTY20DEC1827100CE_2018-12-20.csv,10,7,3,1033.5,33423.0
BANKNIFTY20DEC1827100PE_2018-12-20.csv,16,6,10,-133.5,10692.75
BANKNIFTY20DEC1827200CE_2018-12-20.csv,9,5,4,170.25,10661.25
BANKNIFTY20DEC1827200PE_2018-12-20.csv,12,4,8,-147.75,21213.0
BANKNIFTY20DEC1827300CE_2018-12-20.csv,17,8,9,-82.5,7335.75
BANKNIFTY20DEC1827300PE_2018-12-20.csv,12,2,10,-738.0,36223.5
BANKNIFTY20DEC1827400PE_2018-12-20.csv,16,4,12,-1013.25,94497.75
BANKNIFTY20DEC1827500PE_2018-12-20.csv,15,4,11,-1052.25,123597.75
BANKNIFTY27DEC1826200PE_2018-12-21.csv,19,7,12,-27.75,12704.25
BANKNIFTY27DEC1826300PE_2018-12-21.csv,16,6,10,34.5,12414.0
BANKNIFTY27DEC1826400PE_2018-12-21.csv,13,6,7,88.5,13299.0
BANKNIFTY27DEC1826500PE_2018-12-21.csv,15,9,6,342.75,19917.75
BANKNIFTY27DEC1826600PE_2018-12-21.csv,11,8,3,570.75,19907.25
BANKNIFTY27DEC1826700PE_2018-12-21.csv,15,9,6,572.25,33320.25
BANKNIFTY27DEC1826800PE_2018-12-21.csv,12,5,7,135.0,35455.5
BANKNIFTY27DEC1826900CE_2018-12-21.csv,12,1,11,-3192.0,126898.5
BANKNIFTY27DEC1826900PE_2018-12-21.csv,9,4,5,222.75,34461.75
BANKNIFTY27DEC1827000CE_2018-12-21.csv,14,1,13,-3162.75,117612.75
BANKNIFTY27DEC1827000PE_2018-12-21.csv,11,5,6,510.0,50065.5
BANKNIFTY27DEC1827100CE_2018-12-21.csv,15,1,14,-2791.5,95055.0
BANKNIFTY27DEC1827100PE_2018-12-21.csv,9,5,4,666.75,55953.75
BANKNIFTY27DEC1827200CE_2018-12-21.csv,16,1,15,-2396.25,80615.25
BANKNIFTY27DEC1827200PE_2018-12-21.csv,12,7,5,1449.75,80211.75
BANKNIFTY27DEC1827300CE_2018-12-21.csv,12,0,12,-1529.25,43811.25
BANKNIFTY27DEC1827300PE_2018-12-21.csv,11,7,4,2554.5,105255.75
BANKNIFTY27DEC1827400CE_2018-12-21.csv,14,2,12,-756.75,41700.75
BANKNIFTY27DEC1827400PE_2018-12-21.csv,7,5,2,2329.5,87784.5
BANKNIFTY27DEC1827500CE_2018-12-21.csv,10,0,10,-687.75,21735.0
BANKNIFTY27DEC1827500PE_2018-12-21.csv,9,4,5,1248.0,119602.5
BANKNIFTY27DEC1827600CE_2018-12-21.csv,14,0,14,-709.5,19284.0
BANKNIFTY27DEC1827700CE_2018-12-21.csv,15,3,12,-338.25,15384.75
BANKNIFTY27DEC1827800CE_2018-12-21.csv,17,5,12,-124.5,11593.5
BANKNIFTY27DEC1827900CE_2018-12-21.csv,15,4,11,-96.0,7365.0
BANKNIFTY27DEC1826300PE_2018-12-24.csv,14,4,10,-135.75,10446.75
BANKNIFTY27DEC1826400PE_2018-12-24.csv,8,3,5,-11.25,8691.0
BANKNIFTY27DEC1826500PE_2018-12-24.csv,8,0,8,-415.5,11403.0
BANKNIFTY27DEC1826600CE_2018-12-24.csv,14,6,8,420.0,136705.5
BANKNIFTY27DEC1826600PE_2018-12-24.csv,5,2,3,15.0,10494.0
BANKNIFTY27DEC1826700CE_2018-12-24.csv,11,4,7,-406.5,86041.5
BANKNIFTY27DEC1826700PE_2018-12-24.csv,11,5,6,153.75,29682.75
BANKNIFTY27DEC1826800CE_2018-12-24.csv,11,4,7,-126.0,64015.5
BANKNIFTY27DEC1826800PE_2018-12-24.csv,7,2,5,-190.5,27745.5
BANKNIFTY27DEC1826900CE_2018-12-24.csv,9,5,4,399.75,33399.75
BANKNIFTY27DEC1826900PE_2018-12-24.csv,12,4,8,-265.5,62782.5
BANKNIFTY27DEC1827000CE_2018-12-24.csv,14,6,8,-111.0,38238.0
BANKNIFTY27DEC1827000PE_2018-12-24.csv,8,2,6,-801.75,53834.25
BANKNIFTY27DEC1827100CE_2018-12-24.csv,12,3,9,-370.5,22126.5
BANKNIFTY27DEC1827100PE_2018-12-24.csv,10,5,5,942.75,87314.25
BANKNIFTY27DEC1827200CE_2018-12-24.csv,13,5,8,-85.5,15956.25
BANKNIFTY27DEC1827200PE_2018-12-24.csv,10,3,7,-1224.0,111981.75
BANKNIFTY27DEC1827300CE_2018-12-24.csv,15,5,10,-52.5,12849.75
BANKNIFTY27DEC1827400CE_2018-12-24.csv,21,8,13,-56.25,11777.25
BANKNIFTY27DEC1827500CE_2018-12-24.csv,13,3,10,-81.0,5504.25
BANKNIFTY27DEC1826100PE_2018-12-26.csv,17,4,13,-107.25,8544.75
BANKNIFTY27DEC1826200PE_2018-12-26.csv,16,3,13,-225.75,11511.75
BANKNIFTY27DEC1826300CE_2018-12-26.csv,11,7,4,3037.5,131463.75
BANKNIFTY27DEC1826300PE_2018-12-26.csv,11,3,8,-307.5,12396.75
BANKNIFTY27DEC1826400CE_2018-12-26.csv,9,7,2,2843.25,68976.0
BANKNIFTY27DEC1826400PE_2018-12-26.csv,15,3,12,-457.5,25660.5
BANKNIFTY27DEC1826500CE_2018-12-26.csv,9,4,5,825.75,49449.0
BANKNIFTY27DEC1826500PE_2018-12-26.csv,13,3,10,-357.75,36363.75
BANKNIFTY27DEC1826600CE_2018-12-26.csv,9,5,4,1440.0,44836.5
BANKNIFTY27DEC1826600PE_2018-12-26.csv,10,2,8,-664.5,41299.5
BANKNIFTY27DEC1826700CE_2018-12-26.csv,10,4,6,-198.0,28298.25
BANKNIFTY27DEC1826700PE_2018-12-26.csv,8,2,6,-394.5,45252.0
BANKNIFTY27DEC1826800CE_2018-12-26.csv,10,6,4,55.5,14562.0
BANKNIFTY27DEC1826800PE_2018-12-26.csv,10,1,9,-1797.75,73209.75
BANKNIFTY27DEC1826900CE_2018-12-26.csv,14,8,6,111.0,18742.5
BANKNIFTY27DEC1826900PE_2018-12-26.csv,11,3,8,-701.25,93129.75
BANKNIFTY27DEC1827000PE_2018-12-26.csv,9,0,9,-3042.0,95265.0
BANKNIFTY27DEC1826700CE_2018-12-27.csv,15,4,11,-1691.25,148658.25
BANKNIFTY27DEC1826800CE_2018-12-27.csv,14,5,9,-319.5,110878.5
BANKNIFTY27DEC1826800PE_2018-12-27.csv,19,11,8,84.0,2402.25
BANKNIFTY27DEC1826900CE_2018-12-27.csv,12,2,10,-1759.5,55250.25
BANKNIFTY27DEC1826900PE_2018-12-27.csv,10,7,3,148.5,4731.0
BANKNIFTY27DEC1827000CE_2018-12-27.csv,11,4,7,-527.25,31359.0
BANKNIFTY27DEC1827000PE_2018-12-27.csv,11,7,4,246.75,14094.75
BANKNIFTY27DEC1827100CE_2018-12-27.csv,15,7,8,-231.0,16443.75
BANKNIFTY27DEC1827100PE_2018-12-27.csv,13,6,7,12.0,30363.0
BANKNIFTY27DEC1827200CE_2018-12-27.csv,17,8,9,-176.25,9583.5
BANKNIFTY27DEC1827200PE_2018-12-27.csv,12,4,8,-520.5,61083.0
BANKNIFTY27DEC1827300CE_2018-12-27.csv,21,9,12,-124.5,4218.75
BANKNIFTY27DEC1827300PE_2018-12-27.csv,15,3,12,-2568.75,113586.0
BANKNIFTY27DEC1827400CE_2018-12-27.csv,30,13,17,-36.0,2484.75
BANKNIFTY27DEC1827400PE_2018-12-27.csv,19,7,12,-267.75,190642.5
BANKNIFTY27DEC1827500PE_2018-12-27.csv,18,7,11,250.5,232958.25
BANKNIFTY03JAN1926200PE_2018-12-28.csv,15,5,10,-14.25,5223.75
BANKNIFTY03JAN1926300PE_2018-12-28.csv,9,2,7,-49.5,4150.5
BANKNIFTY03JAN1926400PE_2018-12-28.csv,16,5,11,-55.5,9459.0
BANKNIFTY03JAN1926500PE_2018-12-28.csv,12,5,7,13.5,9454.5
BANKNIFTY03JAN1926600PE_2018-12-28.csv,9,3,6,-21.0,9481.5
BANKNIFTY03JAN1926700PE_2018-12-28.csv,9,3,6,-83.25,12974.25
BANKNIFTY03JAN1926800PE_2018-12-28.csv,8,2,6,-195.75,15886.5
BANKNIFTY03JAN1926900CE_2018-12-28.csv,5,3,2,1059.75,60062.25
BANKNIFTY03JAN1926900PE_2018-12-28.csv,9,4,5,138.0,24963.0
BANKNIFTY03JAN1927000CE_2018-12-28.csv,9,3,6,-325.5,84433.5
BANKNIFTY03JAN1927000PE_2018-12-28.csv,7,2,5,-75.0,25597.5
BANKNIFTY03JAN1927100CE_2018-12-28.csv,9,2,7,-950.25,64557.75
BANKNIFTY03JAN1927100PE_2018-12-28.csv,5,1,4,-316.5,25042.5
BANKNIFTY03JAN1927200CE_2018-12-28.csv,7,3,4,84.75,43124.25
BANKNIFTY03JAN1927200PE_2018-12-28.csv,10,5,5,741.0,62011.5
BANKNIFTY03JAN1927300CE_2018-12-28.csv,9,4,5,-75.75,41782.5
BANKNIFTY03JAN1927300PE_2018-12-28.csv,8,3,5,181.5,63688.5
BANKNIFTY03JAN1927400CE_2018-12-28.csv,9,4,5,121.5,31543.5
BANKNIFTY03JAN1927400PE_2018-12-28.csv,9,4,5,504.0,88165.5
BANKNIFTY03JAN1927500CE_2018-12-28.csv,10,4,6,42.75,24306.75
BANKNIFTY03JAN1927600CE_2018-12-28.csv,12,5,7,114.75,21689.25
BANKNIFTY03JAN1927700CE_2018-12-28.csv,8,3,5,-24.0,9924.0
BANKNIFTY03JAN1927800CE_2018-12-28.csv,9,4,5,37.5,7890.75
BANKNIFTY03JAN1927900CE_2018-12-28.csv,14,4,10,-64.5,7674.0
BANKNIFTY03JAN1926700PE_2018-12-31.csv,12,4,8,-57.75,9572.25
BANKNIFTY03JAN1926800PE_2018-12-31.csv,9,3,6,-48.75,10976.25
BANKNIFTY03JAN1926900PE_2018-12-31.csv,12,5,7,165.0,21294.75
BANKNIFTY03JAN1927000CE_2018-12-31.csv,2,1,1,-76.5,21048.75
BANKNIFTY03JAN1927000PE_2018-12-31.csv,11,3,8,-183.75,28314.75
BANKNIFTY03JAN1927100CE_2018-12-31.csv,5,1,4,-646.5,38875.5
BANKNIFTY03JAN1927100PE_2018-12-31.csv,8,3,5,-61.5,29280.0
BANKNIFTY03JAN1927200CE_2018-12-31.csv,4,0,4,-810.0,24536.25
BANKNIFTY03JAN1927200PE_2018-12-31.csv,7,3,4,168.0,34831.5
BANKNIFTY03JAN1927300CE_2018-12-31.csv,3,0,3,-570.0,14269.5
BANKNIFTY03JAN1927300PE_2018-12-31.csv,6,3,3,541.5,40660.5
BANKNIFTY03JAN1927400CE_2018-12-31.csv,3,0,3,-372.0,10277.25
BANKNIFTY03JAN1927400PE_2018-12-31.csv,5,2,3,-27.0,45236.25
BANKNIFTY03JAN1927500CE_2018-12-31.csv,5,1,4,-256.5,10615.5
BANKNIFTY03JAN1927500PE_2018-12-31.csv,6,1,5,-740.25,66096.0
BANKNIFTY03JAN1927600CE_2018-12-31.csv,9,3,6,-127.5,11522.25
BANKNIFTY03JAN1927700CE_2018-12-31.csv,9,2,7,-154.5,6910.5
BANKNIFTY03JAN1927800CE_2018-12-31.csv,15,5,10,-53.25,6374.25
